AGTTATAATACCAGAGAAGCCGAG -> GTTATAATACCAGAGAAGCCGAGG
ATGTGTGTGGGCACGAACAATGAG -> TGTGTGTGGGCACGAACAATGAGT
CGTTCAGCTTTGAGACTACAAGCG -> GTTCAGCTTTGAGACTACAAGCGG
AAATACTCGGCCATGATGCCGGAA -> AATACTCGGCCATGATGCCGGAAG
GGGAAAGCACCGATCTTCGGCTTC -> GGAAAGCACCGATCTTCGGCTTCA
TGATTGCGGGCCCAGCCTCGGTGG -> GATTGCGGGCCCAGCCTCGGTGGT
AACATCGGAAGAGACATCAACTTA -> ACATCGGAAGAGACATCAACTTAG
GTAGCTGCTGTAGACGTGGTCTCG -> TAGCTGCTGTAGACGTGGTCTCGC
GCGGTTTGGCATTCTGCCAGTTAA -> CGGTTTGGCATTCTGCCAGTTAAA
GGGAAGGTATTTGCTGCTATCGAG -> GGAAGGTATTTGCTGCTATCGAGA
TGGGAAAGCACCGATCTTCGGCTT -> GGGAAAGCACCGATCTTCGGCTTC
TCGAGAAAGGAGCGTAATCCATGG -> CGAGAAAGGAGCGTAATCCATGGG
ATAATCCTTCTAGGCCACCAACGC -> TAATCCTTCTAGGCCACCAACGCA
GACTACAAGCGGTATGCGATGACG -> ACTACAAGCGGTATGCGATGACGA
GCCCAGCCTCGGTGGTGGGCCAGC -> CCCAGCCTCGGTGGTGGGCCAGCC
AGTTTTCGTTCGCAATGGTAGTTG -> GTTTTCGTTCGCAATGGTAGTTGT
CACGGTCTAAATCCAGGCGGCAGC -> ACGGTCTAAATCCAGGCGGCAGCT
CGTGGTCTCGCCCCGGCCCTAGCG -> GTGGTCTCGCCCCGGCCCTAGCGG
GTACTACAAGGTGCCCCTAACACG -> TACTACAAGGTGCCCCTAACACGT
AAGAGACATATTCAGGTGCCCAAC -> AGAGACATATTCAGGTGCCCAACC
TGTAATAAGTGGACCTCATCCGTC -> GTAATAAGTGGACCTCATCCGTCC
TTCAATTTCCAAGATAACTCTGCG -> TCAATTTCCAAGATAACTCTGCGG
AATTTCCAAGATAACTCTGCGGTG -> ATTTCCAAGATAACTCTGCGGTGT
GACCGGAAACATGTCTAGGGTGTT -> ACCGGAAACATGTCTAGGGTGTTA
TACCGGTGGGAAAGCACCGATCTT -> ACCGGTGGGAAAGCACCGATCTTC
GATTGCGGGCCCAGCCTCGGTGGT -> ATTGCGGGCCCAGCCTCGGTGGTG
AGGAGACTGAATTTAATGGATTAG -> GGAGACTGAATTTAATGGATTAGC
TTTCAAGAATGTTCGCGACCGTTA -> TTCAAGAATGTTCGCGACCGTTAT
CAATAAATGGACTAGCCTCTCTGA -> AATAAATGGACTAGCCTCTCTGAT
TCCTTCTAGGCCACCAACGCAACC -> CCTTCTAGGCCACCAACGCAACCA
CTAAAGAGGGCATACACCACGGAG -> TAAAGAGGGCATACACCACGGAGA
GCATCTTCAATTTCCAAGATAACT -> CATCTTCAATTTCCAAGATAACTC
TATGCCATATGGGAAACGGCCTAA -> ATGCCATATGGGAAACGGCCTAAT
TGACGCTAAAGAGGGCATACACCA -> GACGCTAAAGAGGGCATACACCAC
GAACAATGAGTCAAGAGGTTTTGC -> AACAATGAGTCAAGAGGTTTTGCT
TCAGGGGCGAACCACGCTGTCAAA -> CAGGGGCGAACCACGCTGTCAAAT
AAGTGGACCTCATCCGTCCAGACC -> AGTGGACCTCATCCGTCCAGACCT
AACTTAGTATCTGTCTGGCCTGGG -> ACTTAGTATCTGTCTGGCCTGGGG
TAAACTACACGGCTGTGGTCACGG -> AAACTACACGGCTGTGGTCACGGT
GCTCCGGAGGCGTTGGAGACGGTG -> CTCCGGAGGCGTTGGAGACGGTGC
AGCACTATGTGTGTGGGCACGAAC -> GCACTATGTGTGTGGGCACGAACA
GCGTGATGACAAGCGGTTTGGCAT -> CGTGATGACAAGCGGTTTGGCATT
GTCCGATTATCGGTTCCGTTCAGC -> TCCGATTATCGGTTCCGTTCAGCT
GCGGGCCCAGCCTCGGTGGTGGGC -> CGGGCCCAGCCTCGGTGGTGGGCC
AATCAATTGGTTTTCTACCACCTG -> ATCAATTGGTTTTCTACCACCTGT
TTGGCATTCTGCCAGTTAAATACT -> TGGCATTCTGCCAGTTAAATACTC
ATTGGTGCTACGCCACGGCGAATT -> TTGGTGCTACGCCACGGCGAATTT
CCACGGCGAATTTGGTGATCTCAG -> CACGGCGAATTTGGTGATCTCAGT
ATTAAACTACACGGCTGTGGTCAC -> TTAAACTACACGGCTGTGGTCACG
TCGGCTAGTATCGATAAAGTATGG -> CGGCTAGTATCGATAAAGTATGGC
CATCCGTCCAGACCTGAGTATGAT -> ATCCGTCCAGACCTGAGTATGATG
CAGATTGCGGGAAGGTATTTGCTG -> AGATTGCGGGAAGGTATTTGCTGC
GTGCAGCGTGATGACAAGCGGTTT -> TGCAGCGTGATGACAAGCGGTTTG
CAGATCGACTCAGAAGTAGTTTAA -> AGATCGACTCAGAAGTAGTTTAAT
CCGCCGTTAACTATGCGATAAGGT -> CGCCGTTAACTATGCGATAAGGTC
GGCACGAACAATGAGTCAAGAGGT -> GCACGAACAATGAGTCAAGAGGTT
TTGTTCTGTAGAGGGTCGGCCAAT -> TGTTCTGTAGAGGGTCGGCCAATT
CGTTGGAGACGGTGCCATCGGGAA -> GTTGGAGACGGTGCCATCGGGAAG
CCAGAGGGTTTACTAGCGGCGTGC -> CAGAGGGTTTACTAGCGGCGTGCC
ATCGCGTAGGATATTAAACTACAC -> TCGCGTAGGATATTAAACTACACG
GGGAGTAACCCTTAGCAGTATAAG -> GGAGTAACCCTTAGCAGTATAAGG
ATCGCACATTTTGACGCTAAAGAG -> TCGCACATTTTGACGCTAAAGAGG
AATACTCGGCCATGATGCCGGAAG -> ATACTCGGCCATGATGCCGGAAGG
TATGGCAGAACGGGGAGTGATGTG -> ATGGCAGAACGGGGAGTGATGTGC
TTTTCGTTCGCAATGGTAGTTGTC -> TTTCGTTCGCAATGGTAGTTGTCC
CTTGAGTTGTGCTTAGGGGGACAT -> TTGAGTTGTGCTTAGGGGGACATG
GCACTATGTGTGTGGGCACGAACA -> CACTATGTGTGTGGGCACGAACAA
GGCTTCATGCACACTAACGTTGTT -> GCTTCATGCACACTAACGTTGTTC
TTCGGGTGGCGGCCAGGATAGATT -> TCGGGTGGCGGCCAGGATAGATTA
AAGAATGTTCGCGACCGTTATTGA -> AGAATGTTCGCGACCGTTATTGAT
CAACTTGAGTTGTGCTTAGGGGGA -> AACTTGAGTTGTGCTTAGGGGGAC
TACTAAGGATGCAGAGATACCACA -> ACTAAGGATGCAGAGATACCACAA
GGATAGATTATAGAAGCACTGACC -> GATAGATTATAGAAGCACTGACCA
TACTGCCGCCAAGATTCCATCTTT -> ACTGCCGCCAAGATTCCATCTTTT
GATCTTCAGCTCCGGAGGCGTTGG -> ATCTTCAGCTCCGGAGGCGTTGGA
GAACGGGGAGTGATGTGCATACTA -> AACGGGGAGTGATGTGCATACTAA
TTATCTGCTACTGCCGCCAAGATT -> TATCTGCTACTGCCGCCAAGATTC
TGTTCGCGACCGTTATTGATACGT -> GTTCGCGACCGTTATTGATACGTG
CGTGATGACAAGCGGTTTGGCATT -> GTGATGACAAGCGGTTTGGCATTC
CTAGTGTCACTAACCTTTGAGCTA -> TAGTGTCACTAACCTTTGAGCTAA
GTTTTCTACCACCTGTCTCTATGC -> TTTTCTACCACCTGTCTCTATGCC
TAATTCGCTAGTACCAGAGGGTTT -> AATTCGCTAGTACCAGAGGGTTTA
GAAAGCACCGATCTTCGGCTTCAT -> AAAGCACCGATCTTCGGCTTCATG
GGTCTAAATCCAGGCGGCAGCTGT -> GTCTAAATCCAGGCGGCAGCTGTC
CTAGTTCCTATGAGAGCATATCTT -> TAGTTCCTATGAGAGCATATCTTC
CTGATGAGGCGATTTTGTCAGACA -> TGATGAGGCGATTTTGTCAGACAG
TCAGACAGACAATACCGGTGGGAA -> CAGACAGACAATACCGGTGGGAAA
TGACTCTCCGACGTCCTCGGCTGT -> GACTCTCCGACGTCCTCGGCTGTA
GTGTCGGCTAGTATCGATAAAGTA -> TGTCGGCTAGTATCGATAAAGTAT
CGAGAAAGGAGCGTAATCCATGGG -> GAGAAAGGAGCGTAATCCATGGGT
TAGTTGTCCGATTATCGGTTCCGT -> AGTTGTCCGATTATCGGTTCCGTT
TCTTCTAATCCGCGTGAGGGCACA -> CTTCTAATCCGCGTGAGGGCACAA
TGTTCTGTAGAGGGTCGGCCAATT -> GTTCTGTAGAGGGTCGGCCAATTA
GGTGCCCAACCAGGTATTACAGGG -> GTGCCCAACCAGGTATTACAGGGC
CAGGCGGCAGCTGTCTGCTGTAAT -> AGGCGGCAGCTGTCTGCTGTAATA
CCGTTCAGCTTTGAGACTACAAGC -> CGTTCAGCTTTGAGACTACAAGCG
GTTTTCGTTCGCAATGGTAGTTGT -> TTTTCGTTCGCAATGGTAGTTGTC
AAGAAAGAGAGAACACGTGACTGG -> AGAAAGAGAGAACACGTGACTGGT
GAAGAGACATATTCAGGTGCCCAA -> AAGAGACATATTCAGGTGCCCAAC
ACTCAGGGGCGAACCACGCTGTCA -> CTCAGGGGCGAACCACGCTGTCAA
AAGCCACTCAGATTGCGGGAAGGT -> AGCCACTCAGATTGCGGGAAGGTA
GTCCACAATCTAATATCCAACCAC -> TCCACAATCTAATATCCAACCACC
CCGTGGGCTAGCACTATGTGTGTG -> CGTGGGCTAGCACTATGTGTGTGG
TTACAGGGCTGAGTTTTCGTTCGC -> TACAGGGCTGAGTTTTCGTTCGCA
CGAATTTGGTGATCTCAGTTTAGA -> GAATTTGGTGATCTCAGTTTAGAA
CAACCAGGTATTACAGGGCTGAGT -> AACCAGGTATTACAGGGCTGAGTT
GGCTGAGTTTTCGTTCGCAATGGT -> GCTGAGTTTTCGTTCGCAATGGTA
GAGAGAACACGTGACTGGTGTAGG -> AGAGAACACGTGACTGGTGTAGGA
CAAGATTCCATCTTTTAACGCAGC -> AAGATTCCATCTTTTAACGCAGCC
CGAGGGCTCACGGTCTAAATCCAG -> GAGGGCTCACGGTCTAAATCCAGG
TCGCACATTTTGACGCTAAAGAGG -> CGCACATTTTGACGCTAAAGAGGG
CAGGGCTGAGTTTTCGTTCGCAAT -> AGGGCTGAGTTTTCGTTCGCAATG
AGGCTTCTATACTTTAACACGGCC -> GGCTTCTATACTTTAACACGGCCT
CTTTGAGACTACAAGCGGTATGCG -> TTTGAGACTACAAGCGGTATGCGA
CGATTAGTCACTTCGCATTTATTC -> GATTAGTCACTTCGCATTTATTCT
TGGGGGTCCACGGCTACCGCAAGA -> GGGGGTCCACGGCTACCGCAAGAA
ACGTAGCCCCGCTTAGACGCCGTA -> CGTAGCCCCGCTTAGACGCCGTAG
CGCAACCAGGCATGTTTATCTGCT -> GCAACCAGGCATGTTTATCTGCTA
ACCACGCTGTCAAATTTACGCAGT -> CCACGCTGTCAAATTTACGCAGTG
CTTTAACACGGCCTACACGGCAAG -> TTTAACACGGCCTACACGGCAAGA
AATGAGTCAAGAGGTTTTGCTTAT -> ATGAGTCAAGAGGTTTTGCTTATA
GCTACCGCAAGAAAGAGAGAACAC -> CTACCGCAAGAAAGAGAGAACACG
GTTCAGCTTTGAGACTACAAGCGG -> TTCAGCTTTGAGACTACAAGCGGT
ACGGCTACCGCAAGAAAGAGAGAA -> CGGCTACCGCAAGAAAGAGAGAAC
TGTTTATCTGCTACTGCCGCCAAG -> GTTTATCTGCTACTGCCGCCAAGA
GAACGTAGCCCCGCTTAGACGCCG -> AACGTAGCCCCGCTTAGACGCCGT
ATGATGCCGGAAGGTATAATTCGC -> TGATGCCGGAAGGTATAATTCGCT
AGTATCTGTCTGGCCTGGGGGTCC -> GTATCTGTCTGGCCTGGGGGTCCA
ATCGTTGTCTCCTCAAACAACTTG -> TCGTTGTCTCCTCAAACAACTTGA
TTTGCTGCTATCGAGAAAGGAGCG -> TTGCTGCTATCGAGAAAGGAGCGT
ATAATTCGCTAGTACCAGAGGGTT -> TAATTCGCTAGTACCAGAGGGTTT
TCCATACGATCGCACATTTTGACG -> CCATACGATCGCACATTTTGACGC
GGCGGCCAGGATAGATTATAGAAG -> GCGGCCAGGATAGATTATAGAAGC
TGCGGGGAAGTTATAATACCAGAG -> GCGGGGAAGTTATAATACCAGAGA
ACAATACCGGTGGGAAAGCACCGA -> CAATACCGGTGGGAAAGCACCGAT
CGGAAGGTATAATTCGCTAGTACC -> GGAAGGTATAATTCGCTAGTACCA
TGCCATCGGGAAGCCACTCAGATT -> GCCATCGGGAAGCCACTCAGATTG
TGGGATCTTGGCCAAGGAGCACAG -> GGGATCTTGGCCAAGGAGCACAGT
TTGGAGACGGTGCCATCGGGAAGC -> TGGAGACGGTGCCATCGGGAAGCC
TGCGTCTGGCCAATAAATGGACTA -> GCGTCTGGCCAATAAATGGACTAG
CAACGCAACCAGGCATGTTTATCT -> AACGCAACCAGGCATGTTTATCTG
AGTACTGAATCGTTGTCTCCTCAA -> GTACTGAATCGTTGTCTCCTCAAA
ATCCAGGCGGCAGCTGTCTGCTGT -> TCCAGGCGGCAGCTGTCTGCTGTA
GACTCTCCGACGTCCTCGGCTGTA -> ACTCTCCGACGTCCTCGGCTGTAG
CGGTTCCGTTCAGCTTTGAGACTA -> GGTTCCGTTCAGCTTTGAGACTAC
TTAGCGCCAATGTATTAGGCGGTC -> TAGCGCCAATGTATTAGGCGGTCA
GTGCCCAACCAGGTATTACAGGGC -> TGCCCAACCAGGTATTACAGGGCT
TGCTATCGAGAAAGGAGCGTAATC -> GCTATCGAGAAAGGAGCGTAATCC
GTATACTAAGGATGCAGAGATACC -> TATACTAAGGATGCAGAGATACCA
TGGTGATCTCAGTTTAGAACGTAG -> GGTGATCTCAGTTTAGAACGTAGC
TCCTATGAGAGCATATCTTCTAAT -> CCTATGAGAGCATATCTTCTAATC
GGTGAATATTTATTTCGGGTGGCG -> GTGAATATTTATTTCGGGTGGCGG
TTCCAAGATAACTCTGCGGTGTCG -> TCCAAGATAACTCTGCGGTGTCGG
TGGCGGCCAGGATAGATTATAGAA -> GGCGGCCAGGATAGATTATAGAAG
ATGGGAAACGGCCTAATACTAGTT -> TGGGAAACGGCCTAATACTAGTTC
GCAGCGTGATGACAAGCGGTTTGG -> CAGCGTGATGACAAGCGGTTTGGC
CTATCGGACCACTAGTGTCACTAA -> TATCGGACCACTAGTGTCACTAAC
TGAATCTAGTGCGCTCGGCCCCGG -> GAATCTAGTGCGCTCGGCCCCGGT
CGGTATGCGATGACGAGTACTGAA -> GGTATGCGATGACGAGTACTGAAT
CGGGCCCAGCCTCGGTGGTGGGCC -> GGGCCCAGCCTCGGTGGTGGGCCA
TTCCATCTTTTAACGCAGCCGCCG -> TCCATCTTTTAACGCAGCCGCCGT
CCCCGGCCCTAGCGGAAGTCGATA -> CCCGGCCCTAGCGGAAGTCGATAG
AATGTTCGCGACCGTTATTGATAC -> ATGTTCGCGACCGTTATTGATACG
AACACAGATCGACTCAGAAGTAGT -> ACACAGATCGACTCAGAAGTAGTT
CTACTGCCGCCAAGATTCCATCTT -> TACTGCCGCCAAGATTCCATCTTT
TCTCCTCAAACAACTTGAGTTGTG -> CTCCTCAAACAACTTGAGTTGTGC
CACGGTCGGAAGAGACATATTCAG -> ACGGTCGGAAGAGACATATTCAGG
TAACCCTTAGCAGTATAAGGCTTC -> AACCCTTAGCAGTATAAGGCTTCT
CTACCGCAAGAAAGAGAGAACACG -> TACCGCAAGAAAGAGAGAACACGT
TGTCTCTATGCCATATGGGAAACG -> GTCTCTATGCCATATGGGAAACGG
TGAGAGCATATCTTCTAATCCGCG -> GAGAGCATATCTTCTAATCCGCGT
CCTTCTAGGCCACCAACGCAACCA -> CTTCTAGGCCACCAACGCAACCAG
CGGCTAGTATCGATAAAGTATGGC -> GGCTAGTATCGATAAAGTATGGCA
AGAGGGTCGGCCAATTATACCGTG -> GAGGGTCGGCCAATTATACCGTGG
CGCAATAATCCTTCTAGGCCACCA -> GCAATAATCCTTCTAGGCCACCAA
TTTCCAAGATAACTCTGCGGTGTC -> TTCCAAGATAACTCTGCGGTGTCG
TTAACGCAGCCGCCGTTAACTATG -> TAACGCAGCCGCCGTTAACTATGC
CATATGGGAAACGGCCTAATACTA -> ATATGGGAAACGGCCTAATACTAG
GGTATTTGCTGCTATCGAGAAAGG -> GTATTTGCTGCTATCGAGAAAGGA
TTCTACCACCTGTCTCTATGCCAT -> TCTACCACCTGTCTCTATGCCATA
ACTAGCGGCGTGCCGTACGGATGA -> CTAGCGGCGTGCCGTACGGATGAT
TTAGCAGTATAAGGCTTCTATACT -> TAGCAGTATAAGGCTTCTATACTT
GGGGTCCACGGCTACCGCAAGAAA -> GGGTCCACGGCTACCGCAAGAAAG
ACTAGCCTCTCTGATGAGGCGATT -> CTAGCCTCTCTGATGAGGCGATTT
CGGCAAGATCTTCAGCTCCGGAGG -> GGCAAGATCTTCAGCTCCGGAGGC
GAAAGGAGCGTAATCCATGGGTGC -> AAAGGAGCGTAATCCATGGGTGCA
GGCGAATTTGGTGATCTCAGTTTA -> GCGAATTTGGTGATCTCAGTTTAG
CTGAATCTAGTGCGCTCGGCCCCG -> TGAATCTAGTGCGCTCGGCCCCGG
TAAGTGGACCTCATCCGTCCAGAC -> AAGTGGACCTCATCCGTCCAGACC
CGTCCAGACCTGAGTATGATGGGA -> GTCCAGACCTGAGTATGATGGGAG
CTTGAAACACAGATCGACTCAGAA -> TTGAAACACAGATCGACTCAGAAG
TTATACGCGGTAGCTGCTGTAGAC -> TATACGCGGTAGCTGCTGTAGACG
TAACGGCATGCTGCTTTCATCTCC -> AACGGCATGCTGCTTTCATCTCCA
TAAGCACGTGCAGCGTGATGACAA -> AAGCACGTGCAGCGTGATGACAAG
TTGACGCTAAAGAGGGCATACACC -> TGACGCTAAAGAGGGCATACACCA
TGTGCATACTAAGCACGTGCAGCG -> GTGCATACTAAGCACGTGCAGCGT
TGCCATATGGGAAACGGCCTAATA -> GCCATATGGGAAACGGCCTAATAC
CGCCACGGCGAATTTGGTGATCTC -> GCCACGGCGAATTTGGTGATCTCA
ATACACCACGGAGAACGCTGACTC -> TACACCACGGAGAACGCTGACTCT
AGCGGTATGCGATGACGAGTACTG -> GCGGTATGCGATGACGAGTACTGA
AGAGGGTTTACTAGCGGCGTGCCG -> GAGGGTTTACTAGCGGCGTGCCGT
CTACGCCACGGCGAATTTGGTGAT -> TACGCCACGGCGAATTTGGTGATC
AGTGGCTTAGCGCCAATGTATTAG -> GTGGCTTAGCGCCAATGTATTAGG
TGCTGCTTTCATCTCCAAGTGGCT -> GCTGCTTTCATCTCCAAGTGGCTT
GGCCAGGATAGATTATAGAAGCAC -> GCCAGGATAGATTATAGAAGCACT
TTTCGGGTGGCGGCCAGGATAGAT -> TTCGGGTGGCGGCCAGGATAGATT
ACTTTAACACGGCCTACACGGCAA -> CTTTAACACGGCCTACACGGCAAG
TTCAGCTTTGAGACTACAAGCGGT -> TCAGCTTTGAGACTACAAGCGGTA
TCTGCCAGTTAAATACTCGGCCAT -> CTGCCAGTTAAATACTCGGCCATG
GCCGAGGGCTCACGGTCTAAATCC -> CCGAGGGCTCACGGTCTAAATCCA
CTGCTACTGCCGCCAAGATTCCAT -> TGCTACTGCCGCCAAGATTCCATC
ATGCCGATCGCGTAGGATATTAAA -> TGCCGATCGCGTAGGATATTAAAC
GAGAAAGGAGCGTAATCCATGGGT -> AGAAAGGAGCGTAATCCATGGGTG
ATGAGTCAAGAGGTTTTGCTTATA -> TGAGTCAAGAGGTTTTGCTTATAC
AGTCAAGAGGTTTTGCTTATACGC -> GTCAAGAGGTTTTGCTTATACGCG
ATCTTCAGCTCCGGAGGCGTTGGA -> TCTTCAGCTCCGGAGGCGTTGGAG
AGGTATTTGCTGCTATCGAGAAAG -> GGTATTTGCTGCTATCGAGAAAGG
ACGCCACGGCGAATTTGGTGATCT -> CGCCACGGCGAATTTGGTGATCTC
TTCATGCACACTAACGTTGTTCTG -> TCATGCACACTAACGTTGTTCTGT
AACACGTTAGGAGTGCGTCTGGCC -> ACACGTTAGGAGTGCGTCTGGCCA
CTAACCTTTGAGCTAACTCAGGGG -> TAACCTTTGAGCTAACTCAGGGGC
GCCCCGCTTAGACGCCGTAGTAAC -> CCCCGCTTAGACGCCGTAGTAACT
CAAGATCTTCAGCTCCGGAGGCGT -> AAGATCTTCAGCTCCGGAGGCGTT
CCGACGTCCTCGGCTGTAGGTCTT -> CGACGTCCTCGGCTGTAGGTCTTG
GTATATGTCCTATCGGACCACTAG -> TATATGTCCTATCGGACCACTAGT
CGCTAAAGAGGGCATACACCACGG -> GCTAAAGAGGGCATACACCACGGA
GAAGCACTGACCAACACGCACGAC -> AAGCACTGACCAACACGCACGACT
GGACCGGGAGAGACCGGAAACATG -> GACCGGGAGAGACCGGAAACATGT
GAGGTTTTGCTTATACGCGGTAGC -> AGGTTTTGCTTATACGCGGTAGCT
TCTCCAAGTGGCTTAGCGCCAATG -> CTCCAAGTGGCTTAGCGCCAATGT
AAAATGTAAATTGGTGCTACGCCA -> AAATGTAAATTGGTGCTACGCCAC
TGCCGATCGCGTAGGATATTAAAC -> GCCGATCGCGTAGGATATTAAACT
CTCATCCGTCCAGACCTGAGTATG -> TCATCCGTCCAGACCTGAGTATGA
AGTTTAATGCCGATCGCGTAGGAT -> GTTTAATGCCGATCGCGTAGGATA
GATTATCGGTTCCGTTCAGCTTTG -> ATTATCGGTTCCGTTCAGCTTTGA
ACCGGTGGGAAAGCACCGATCTTC -> CCGGTGGGAAAGCACCGATCTTCG
TGGATTAGCGAAATGTTGATTGCG -> GGATTAGCGAAATGTTGATTGCGG
GGGCACGAACAATGAGTCAAGAGG -> GGCACGAACAATGAGTCAAGAGGT
CAGACAATACCGGTGGGAAAGCAC -> AGACAATACCGGTGGGAAAGCACC
GGCGATTTTGTCAGACAGACAATA -> GCGATTTTGTCAGACAGACAATAC
AACTTTCAAGAATGTTCGCGACCG -> ACTTTCAAGAATGTTCGCGACCGT
GGTGTAGGAGACTGAATTTAATGG -> GTGTAGGAGACTGAATTTAATGGA
GGTCCATACGATCGCACATTTTGA -> GTCCATACGATCGCACATTTTGAC
ACGCACGACTTGAAACACAGATCG -> CGCACGACTTGAAACACAGATCGA
TAATCCTTCTAGGCCACCAACGCA -> AATCCTTCTAGGCCACCAACGCAA
TCTTGGCCAAGGAGCACAGTATAT -> CTTGGCCAAGGAGCACAGTATATG
AGTGTCACTAACCTTTGAGCTAAC -> GTGTCACTAACCTTTGAGCTAACT
TTAGTATCTGTCTGGCCTGGGGGT -> TAGTATCTGTCTGGCCTGGGGGTC
GCGGCGTGCCGTACGGATGATGCT -> CGGCGTGCCGTACGGATGATGCTG
AGGATAGATTATAGAAGCACTGAC -> GGATAGATTATAGAAGCACTGACC
GTCTCGCCCCGGCCCTAGCGGAAG -> TCTCGCCCCGGCCCTAGCGGAAGT
GAATCTAGTGCGCTCGGCCCCGGT -> AATCTAGTGCGCTCGGCCCCGGTA
ATCTTCTAATCCGCGTGAGGGCAC -> TCTTCTAATCCGCGTGAGGGCACA
CACCCGGCGATTAGTCACTTCGCA -> ACCCGGCGATTAGTCACTTCGCAT
TTGGTGCTACGCCACGGCGAATTT -> TGGTGCTACGCCACGGCGAATTTG
GCCTAATACTAGTTCCTATGAGAG -> CCTAATACTAGTTCCTATGAGAGC
ACTAGTGTCACTAACCTTTGAGCT -> CTAGTGTCACTAACCTTTGAGCTA
TGCTGTAGACGTGGTCTCGCCCCG -> GCTGTAGACGTGGTCTCGCCCCGG
ATTTATTTCGGGTGGCGGCCAGGA -> TTTATTTCGGGTGGCGGCCAGGAT
TCCAGACCTGAGTATGATGGGAGT -> CCAGACCTGAGTATGATGGGAGTA
TATTAAACTACACGGCTGTGGTCA -> ATTAAACTACACGGCTGTGGTCAC
AAACATGTCTAGGGTGTTACCATT -> AACATGTCTAGGGTGTTACCATTG
TAACTCTGCGGTGTCGGCTAGTAT -> AACTCTGCGGTGTCGGCTAGTATC
TTCGCATTTATTCTCTCGACGGTA -> TCGCATTTATTCTCTCGACGGTAC
CCGTAGTAACTTTCAAGAATGTTC -> CGTAGTAACTTTCAAGAATGTTCG
TTAGCGAAATGTTGATTGCGGGCC -> TAGCGAAATGTTGATTGCGGGCCC
AATGTTGATTGCGGGCCCAGCCTC -> ATGTTGATTGCGGGCCCAGCCTCG
TCTAGGCCACCAACGCAACCAGGC -> CTAGGCCACCAACGCAACCAGGCA
TAGGAGTGCGTCTGGCCAATAAAT -> AGGAGTGCGTCTGGCCAATAAATG
AGTTGTCCGATTATCGGTTCCGTT -> GTTGTCCGATTATCGGTTCCGTTC
GTGTAGGAGACTGAATTTAATGGA -> TGTAGGAGACTGAATTTAATGGAT
TAGGTCTTGAACATCGGAAGAGAC -> AGGTCTTGAACATCGGAAGAGACA
ATAAGTGGACCTCATCCGTCCAGA -> TAAGTGGACCTCATCCGTCCAGAC
TCCGCTAGCTTTAACAATATGGTC -> CCGCTAGCTTTAACAATATGGTCC
AGATTATAGAAGCACTGACCAACA -> GATTATAGAAGCACTGACCAACAC
TCAAGAGGTTTTGCTTATACGCGG -> CAAGAGGTTTTGCTTATACGCGGT
TTTACTAGCGGCGTGCCGTACGGA -> TTACTAGCGGCGTGCCGTACGGAT
TATCGATAAAGTATGGCAGAACGG -> ATCGATAAAGTATGGCAGAACGGG
AGCGTGATGACAAGCGGTTTGGCA -> GCGTGATGACAAGCGGTTTGGCAT
ACCGCAAGAAAGAGAGAACACGTG -> CCGCAAGAAAGAGAGAACACGTGA
GCTGACTCTCCGACGTCCTCGGCT -> CTGACTCTCCGACGTCCTCGGCTG
CTGTGGTCACGGTCGGAAGAGACA -> TGTGGTCACGGTCGGAAGAGACAT
AGTTAAATACTCGGCCATGATGCC -> GTTAAATACTCGGCCATGATGCCG
TAGCGGAAGTCGATAGGTGAATAT -> AGCGGAAGTCGATAGGTGAATATT
GTCAAGCGATGCGGGGAAGTTATA -> TCAAGCGATGCGGGGAAGTTATAA
TTGAGTTGTGCTTAGGGGGACATG -> TGAGTTGTGCTTAGGGGGACATGA
ACAAGCGGTATGCGATGACGAGTA -> CAAGCGGTATGCGATGACGAGTAC
CAATATGGTCCACAATCTAATATC -> AATATGGTCCACAATCTAATATCC
TATATGTCCTATCGGACCACTAGT -> ATATGTCCTATCGGACCACTAGTG
GGTCTCGCCCCGGCCCTAGCGGAA -> GTCTCGCCCCGGCCCTAGCGGAAG
TATCTTCTAATCCGCGTGAGGGCA -> ATCTTCTAATCCGCGTGAGGGCAC
TACTAGCGGCGTGCCGTACGGATG -> ACTAGCGGCGTGCCGTACGGATGA
GCCGTTAACTATGCGATAAGGTCC -> CCGTTAACTATGCGATAAGGTCCA
TTTTAAGGTAAGCTACCAAAAATG -> TTTAAGGTAAGCTACCAAAAATGT
CAAAAATGTAAATTGGTGCTACGC -> AAAAATGTAAATTGGTGCTACGCC
AACAATATGGTCCACAATCTAATA -> ACAATATGGTCCACAATCTAATAT
AGGCGATTTTGTCAGACAGACAAT -> GGCGATTTTGTCAGACAGACAATA
GATGCAGAGATACCACAATCAATT -> ATGCAGAGATACCACAATCAATTG
TTAACTATGCGATAAGGTCCATAC -> TAACTATGCGATAAGGTCCATACG
ACTTCGCATTTATTCTCTCGACGG -> CTTCGCATTTATTCTCTCGACGGT
AATGTATTAGGCGGTCAAGCGATG -> ATGTATTAGGCGGTCAAGCGATGC
ATCCTTCTAGGCCACCAACGCAAC -> TCCTTCTAGGCCACCAACGCAACC
AACTCTGCGGTGTCGGCTAGTATC -> ACTCTGCGGTGTCGGCTAGTATCG
CCGCTAGCTTTAACAATATGGTCC -> CGCTAGCTTTAACAATATGGTCCA
GTGTGGGCACGAACAATGAGTCAA -> TGTGGGCACGAACAATGAGTCAAG
ACCTCATCCGTCCAGACCTGAGTA -> CCTCATCCGTCCAGACCTGAGTAT
AGACAATACCGGTGGGAAAGCACC -> GACAATACCGGTGGGAAAGCACCG
GAGAGACCGGAAACATGTCTAGGG -> AGAGACCGGAAACATGTCTAGGGT
GGGAGTGATGTGCATACTAAGCAC -> GGAGTGATGTGCATACTAAGCACG
TATGGTCAAACTTTAACGGCATGC -> ATGGTCAAACTTTAACGGCATGCT
GTTTTGCTTATACGCGGTAGCTGC -> TTTTGCTTATACGCGGTAGCTGCT
AGACAGACAATACCGGTGGGAAAG -> GACAGACAATACCGGTGGGAAAGC
CAATGTATTAGGCGGTCAAGCGAT -> AATGTATTAGGCGGTCAAGCGATG
TGGTAGTTGTCCGATTATCGGTTC -> GGTAGTTGTCCGATTATCGGTTCC
TCTTCAATTTCCAAGATAACTCTG -> CTTCAATTTCCAAGATAACTCTGC
ATGACAAGCGGTTTGGCATTCTGC -> TGACAAGCGGTTTGGCATTCTGCC
CCAGAGAAGCCGAGGGCTCACGGT -> CAGAGAAGCCGAGGGCTCACGGTC
ACAATGTCCGCTAGCTTTAACAAT -> CAATGTCCGCTAGCTTTAACAATA
AGGTGCCCCTAACACGTTAGGAGT -> GGTGCCCCTAACACGTTAGGAGTG
AGCGTAATCCATGGGTGCATCTTC -> GCGTAATCCATGGGTGCATCTTCA
GCGCTCGGCCCCGGTATGTAATCC -> CGCTCGGCCCCGGTATGTAATCCG
GGGCTGAGTTTTCGTTCGCAATGG -> GGCTGAGTTTTCGTTCGCAATGGT
GCGCCAATGTATTAGGCGGTCAAG -> CGCCAATGTATTAGGCGGTCAAGC
ATTTAATGGATTAGCGAAATGTTG -> TTTAATGGATTAGCGAAATGTTGA
TCTAAATCCAGGCGGCAGCTGTCT -> CTAAATCCAGGCGGCAGCTGTCTG
GGCCTACACGGCAAGATCTTCAGC -> GCCTACACGGCAAGATCTTCAGCT
AGACGTGGTCTCGCCCCGGCCCTA -> GACGTGGTCTCGCCCCGGCCCTAG
CCATACGATCGCACATTTTGACGC -> CATACGATCGCACATTTTGACGCT
GCCAGCCTTTTAAGGTAAGCTACC -> CCAGCCTTTTAAGGTAAGCTACCA
ACATGATTCTCTATTGACCTATGG -> CATGATTCTCTATTGACCTATGGT
TTAAATACTCGGCCATGATGCCGG -> TAAATACTCGGCCATGATGCCGGA
GCATTTATTCTCTCGACGGTACTA -> CATTTATTCTCTCGACGGTACTAC
TAATACCAGAGAAGCCGAGGGCTC -> AATACCAGAGAAGCCGAGGGCTCA
ATACTCGGCCATGATGCCGGAAGG -> TACTCGGCCATGATGCCGGAAGGT
TTTAATGCCGATCGCGTAGGATAT -> TTAATGCCGATCGCGTAGGATATT
CCTGTCTCTATGCCATATGGGAAA -> CTGTCTCTATGCCATATGGGAAAC
GGTGCCCCTAACACGTTAGGAGTG -> GTGCCCCTAACACGTTAGGAGTGC
ACGGAGAACGCTGACTCTCCGACG -> CGGAGAACGCTGACTCTCCGACGT
ACCATTGGGATCTTGGCCAAGGAG -> CCATTGGGATCTTGGCCAAGGAGC
GGCCCTAGCGGAAGTCGATAGGTG -> GCCCTAGCGGAAGTCGATAGGTGA
TTACCATTGGGATCTTGGCCAAGG -> TACCATTGGGATCTTGGCCAAGGA
GCTAGCTTTAACAATATGGTCCAC -> CTAGCTTTAACAATATGGTCCACA
AGAGACATATTCAGGTGCCCAACC -> GAGACATATTCAGGTGCCCAACCA
AGAACGCTGACTCTCCGACGTCCT -> GAACGCTGACTCTCCGACGTCCTC
TAGACGCCGTAGTAACTTTCAAGA -> AGACGCCGTAGTAACTTTCAAGAA
CAATTGGTTTTCTACCACCTGTCT -> AATTGGTTTTCTACCACCTGTCTC
GGTACTACAAGGTGCCCCTAACAC -> GTACTACAAGGTGCCCCTAACACG
TATCTGCTACTGCCGCCAAGATTC -> ATCTGCTACTGCCGCCAAGATTCC
ATCTAGTGCGCTCGGCCCCGGTAT -> TCTAGTGCGCTCGGCCCCGGTATG
GGGAAGTTATAATACCAGAGAAGC -> GGAAGTTATAATACCAGAGAAGCC
AGCGAAATGTTGATTGCGGGCCCA -> GCGAAATGTTGATTGCGGGCCCAG
TCTCTATTGACCTATGGTCAAACT -> CTCTATTGACCTATGGTCAAACTT
GTTGTCCGATTATCGGTTCCGTTC -> TTGTCCGATTATCGGTTCCGTTCA
CTAACACGTTAGGAGTGCGTCTGG -> TAACACGTTAGGAGTGCGTCTGGC
CAATTTCCAAGATAACTCTGCGGT -> AATTTCCAAGATAACTCTGCGGTG
CGGGTGGCGGCCAGGATAGATTAT -> GGGTGGCGGCCAGGATAGATTATA
CCTTTGAGCTAACTCAGGGGCGAA -> CTTTGAGCTAACTCAGGGGCGAAC
CGCGGTAGCTGCTGTAGACGTGGT -> GCGGTAGCTGCTGTAGACGTGGTC
GGCAGAACGGGGAGTGATGTGCAT -> GCAGAACGGGGAGTGATGTGCATA
ACCGATCTTCGGCTTCATGCACAC -> CCGATCTTCGGCTTCATGCACACT
CCGATCGCGTAGGATATTAAACTA -> CGATCGCGTAGGATATTAAACTAC
TTTATTTCGGGTGGCGGCCAGGAT -> TTATTTCGGGTGGCGGCCAGGATA
TAGTATCGATAAAGTATGGCAGAA -> AGTATCGATAAAGTATGGCAGAAC
GACGCCGTAGTAACTTTCAAGAAT -> ACGCCGTAGTAACTTTCAAGAATG
GAAACGGCCTAATACTAGTTCCTA -> AAACGGCCTAATACTAGTTCCTAT
CGAGTACTGAATCGTTGTCTCCTC -> GAGTACTGAATCGTTGTCTCCTCA
AAAAATGTAAATTGGTGCTACGCC -> AAAATGTAAATTGGTGCTACGCCA
ATGCTGAATCTAGTGCGCTCGGCC -> TGCTGAATCTAGTGCGCTCGGCCC
TTCGTTCGCAATGGTAGTTGTCCG -> TCGTTCGCAATGGTAGTTGTCCGA
TAGACGTGGTCTCGCCCCGGCCCT -> AGACGTGGTCTCGCCCCGGCCCTA
CTAGCGGCGTGCCGTACGGATGAT -> TAGCGGCGTGCCGTACGGATGATG
CTATGGTCAAACTTTAACGGCATG -> TATGGTCAAACTTTAACGGCATGC
AAGCACTGACCAACACGCACGACT -> AGCACTGACCAACACGCACGACTT
CCCTAGCGGAAGTCGATAGGTGAA -> CCTAGCGGAAGTCGATAGGTGAAT
CGGCATGCTGCTTTCATCTCCAAG -> GGCATGCTGCTTTCATCTCCAAGT
GCCCCGGCCCTAGCGGAAGTCGAT -> CCCCGGCCCTAGCGGAAGTCGATA
TTGCGGGAAGGTATTTGCTGCTAT -> TGCGGGAAGGTATTTGCTGCTATC
GTACGGATGATGCTGAATCTAGTG -> TACGGATGATGCTGAATCTAGTGC
CCGATTATCGGTTCCGTTCAGCTT -> CGATTATCGGTTCCGTTCAGCTTT
TCTTCGGCTTCATGCACACTAACG -> CTTCGGCTTCATGCACACTAACGT
CTCTATGCCATATGGGAAACGGCC -> TCTATGCCATATGGGAAACGGCCT
GTGGACCTCATCCGTCCAGACCTG -> TGGACCTCATCCGTCCAGACCTGA
ATTCTCTATTGACCTATGGTCAAA -> TTCTCTATTGACCTATGGTCAAAC
TATCGGTTCCGTTCAGCTTTGAGA -> ATCGGTTCCGTTCAGCTTTGAGAC
ACGGTGCCATCGGGAAGCCACTCA -> CGGTGCCATCGGGAAGCCACTCAG
TGACGAGTACTGAATCGTTGTCTC -> GACGAGTACTGAATCGTTGTCTCC
GGAGCACAGTATATGTCCTATCGG -> GAGCACAGTATATGTCCTATCGGA
ACGACTTGAAACACAGATCGACTC -> CGACTTGAAACACAGATCGACTCA
AAATGGACTAGCCTCTCTGATGAG -> AATGGACTAGCCTCTCTGATGAGG
GTTGTCTCCTCAAACAACTTGAGT -> TTGTCTCCTCAAACAACTTGAGTT
GAATTTGGTGATCTCAGTTTAGAA -> AATTTGGTGATCTCAGTTTAGAAC
GATAGATTATAGAAGCACTGACCA -> ATAGATTATAGAAGCACTGACCAA
CGGTTTGGCATTCTGCCAGTTAAA -> GGTTTGGCATTCTGCCAGTTAAAT
GTGGCTTAGCGCCAATGTATTAGG -> TGGCTTAGCGCCAATGTATTAGGC
CTACCACCTGTCTCTATGCCATAT -> TACCACCTGTCTCTATGCCATATG
GAACCACGCTGTCAAATTTACGCA -> AACCACGCTGTCAAATTTACGCAG
CTGTCTCTATGCCATATGGGAAAC -> TGTCTCTATGCCATATGGGAAACG
GTTTAGAACGTAGCCCCGCTTAGA -> TTTAGAACGTAGCCCCGCTTAGAC
GTTGTGCTTAGGGGGACATGATTC -> TTGTGCTTAGGGGGACATGATTCT
CGGTCTAAATCCAGGCGGCAGCTG -> GGTCTAAATCCAGGCGGCAGCTGT
GTTTGGCATTCTGCCAGTTAAATA -> TTTGGCATTCTGCCAGTTAAATAC
CAGCTGTCTGCTGTAATAAGTGGA -> AGCTGTCTGCTGTAATAAGTGGAC
CGCACATTTTGACGCTAAAGAGGG -> GCACATTTTGACGCTAAAGAGGGC
GGTGCTACGCCACGGCGAATTTGG -> GTGCTACGCCACGGCGAATTTGGT
TATACTAAGGATGCAGAGATACCA -> ATACTAAGGATGCAGAGATACCAC
TCAGCTCCGGAGGCGTTGGAGACG -> CAGCTCCGGAGGCGTTGGAGACGG
GGAGTGATGTGCATACTAAGCACG -> GAGTGATGTGCATACTAAGCACGT
CTGAGTATGATGGGAGTAACCCTT -> TGAGTATGATGGGAGTAACCCTTA
AGTTTAGAACGTAGCCCCGCTTAG -> GTTTAGAACGTAGCCCCGCTTAGA
GCAGCTGTCTGCTGTAATAAGTGG -> CAGCTGTCTGCTGTAATAAGTGGA
AGCGGAAGTCGATAGGTGAATATT -> GCGGAAGTCGATAGGTGAATATTT
GTATCTGTCTGGCCTGGGGGTCCA -> TATCTGTCTGGCCTGGGGGTCCAC
TACCAGAGGGTTTACTAGCGGCGT -> ACCAGAGGGTTTACTAGCGGCGTG
CTAAATCCAGGCGGCAGCTGTCTG -> TAAATCCAGGCGGCAGCTGTCTGC
CCGCTTAGACGCCGTAGTAACTTT -> CGCTTAGACGCCGTAGTAACTTTC
GCCCCGGTATGTAATCCGCAATAA -> CCCCGGTATGTAATCCGCAATAAT
GGAGACGGTGCCATCGGGAAGCCA -> GAGACGGTGCCATCGGGAAGCCAC
TTTAGAACGTAGCCCCGCTTAGAC -> TTAGAACGTAGCCCCGCTTAGACG
ACTGAATCGTTGTCTCCTCAAACA -> CTGAATCGTTGTCTCCTCAAACAA
TCGGCCCCGGTATGTAATCCGCAA -> CGGCCCCGGTATGTAATCCGCAAT
CAGCGTGATGACAAGCGGTTTGGC -> AGCGTGATGACAAGCGGTTTGGCA
AAGCGATGCGGGGAAGTTATAATA -> AGCGATGCGGGGAAGTTATAATAC
ACCACTAGTGTCACTAACCTTTGA -> CCACTAGTGTCACTAACCTTTGAG
TGAATCGTTGTCTCCTCAAACAAC -> GAATCGTTGTCTCCTCAAACAACT
AGAAAGGAGCGTAATCCATGGGTG -> GAAAGGAGCGTAATCCATGGGTGC
CAAGAAAGAGAGAACACGTGACTG -> AAGAAAGAGAGAACACGTGACTGG
AGGGGCGAACCACGCTGTCAAATT -> GGGGCGAACCACGCTGTCAAATTT
TCCGACGTCCTCGGCTGTAGGTCT -> CCGACGTCCTCGGCTGTAGGTCTT
TCTGGCCTGGGGGTCCACGGCTAC -> CTGGCCTGGGGGTCCACGGCTACC
ATCTCAGTTTAGAACGTAGCCCCG -> TCTCAGTTTAGAACGTAGCCCCGC
GTTCCTATGAGAGCATATCTTCTA -> TTCCTATGAGAGCATATCTTCTAA
TGTAGGAGACTGAATTTAATGGAT -> GTAGGAGACTGAATTTAATGGATT
TGCTGAATCTAGTGCGCTCGGCCC -> GCTGAATCTAGTGCGCTCGGCCCC
CCAAGATTCCATCTTTTAACGCAG -> CAAGATTCCATCTTTTAACGCAGC
ATCTAATATCCAACCACCCGGCGA -> TCTAATATCCAACCACCCGGCGAT
ACACTAACGTTGTTCTGTAGAGGG -> CACTAACGTTGTTCTGTAGAGGGT
AATCCGCAATAATCCTTCTAGGCC -> ATCCGCAATAATCCTTCTAGGCCA
AAGCTACCAAAAATGTAAATTGGT -> AGCTACCAAAAATGTAAATTGGTG
GAGCGTAATCCATGGGTGCATCTT -> AGCGTAATCCATGGGTGCATCTTC
CAGGCATGTTTATCTGCTACTGCC -> AGGCATGTTTATCTGCTACTGCCG
CATCAACTTAGTATCTGTCTGGCC -> ATCAACTTAGTATCTGTCTGGCCT
TAGTGTCACTAACCTTTGAGCTAA -> AGTGTCACTAACCTTTGAGCTAAC
TATTAGGCGGTCAAGCGATGCGGG -> ATTAGGCGGTCAAGCGATGCGGGG
GTATTACAGGGCTGAGTTTTCGTT -> TATTACAGGGCTGAGTTTTCGTTC
GTGCCATCGGGAAGCCACTCAGAT -> TGCCATCGGGAAGCCACTCAGATT
CACACTAACGTTGTTCTGTAGAGG -> ACACTAACGTTGTTCTGTAGAGGG
CATGCACACTAACGTTGTTCTGTA -> ATGCACACTAACGTTGTTCTGTAG
GCGATAAGGTCCATACGATCGCAC -> CGATAAGGTCCATACGATCGCACA
ATGATTCTCTATTGACCTATGGTC -> TGATTCTCTATTGACCTATGGTCA
GCGGAAGTCGATAGGTGAATATTT -> CGGAAGTCGATAGGTGAATATTTA
GACCTGAGTATGATGGGAGTAACC -> ACCTGAGTATGATGGGAGTAACCC
AAGTCGATAGGTGAATATTTATTT -> AGTCGATAGGTGAATATTTATTTC
GACCACTAGTGTCACTAACCTTTG -> ACCACTAGTGTCACTAACCTTTGA
ATCGGACCACTAGTGTCACTAACC -> TCGGACCACTAGTGTCACTAACCT
CCCAGCCTCGGTGGTGGGCCAGCC -> CCAGCCTCGGTGGTGGGCCAGCCT
GGGCCCAGCCTCGGTGGTGGGCCA -> GGCCCAGCCTCGGTGGTGGGCCAG
GGTCGGCCAATTATACCGTGGGCT -> GTCGGCCAATTATACCGTGGGCTA
TGCTGTAATAAGTGGACCTCATCC -> GCTGTAATAAGTGGACCTCATCCG
AGTATCGATAAAGTATGGCAGAAC -> GTATCGATAAAGTATGGCAGAACG
TACCGCAAGAAAGAGAGAACACGT -> ACCGCAAGAAAGAGAGAACACGTG
GTATCGATAAAGTATGGCAGAACG -> TATCGATAAAGTATGGCAGAACGG
GGGTGTTACCATTGGGATCTTGGC -> GGTGTTACCATTGGGATCTTGGCC
ATCTTCGGCTTCATGCACACTAAC -> TCTTCGGCTTCATGCACACTAACG
ATAGAAGCACTGACCAACACGCAC -> TAGAAGCACTGACCAACACGCACG
AACCTTTGAGCTAACTCAGGGGCG -> ACCTTTGAGCTAACTCAGGGGCGA
CCACAATCTAATATCCAACCACCC -> CACAATCTAATATCCAACCACCCG
CCAACCACCCGGCGATTAGTCACT -> CAACCACCCGGCGATTAGTCACTT
AGTATGATGGGAGTAACCCTTAGC -> GTATGATGGGAGTAACCCTTAGCA
ATATCCAACCACCCGGCGATTAGT -> TATCCAACCACCCGGCGATTAGTC
CGTACGGATGATGCTGAATCTAGT -> GTACGGATGATGCTGAATCTAGTG
GACCGTTATTGATACGTGGGACCG -> ACCGTTATTGATACGTGGGACCGG
ACCAACACGCACGACTTGAAACAC -> CCAACACGCACGACTTGAAACACA
GTTGGAGACGGTGCCATCGGGAAG -> TTGGAGACGGTGCCATCGGGAAGC
TAGCAGTATAAGGCTTCTATACTT -> AGCAGTATAAGGCTTCTATACTTT
AGACGCCGTAGTAACTTTCAAGAA -> GACGCCGTAGTAACTTTCAAGAAT
AACCAGGTATTACAGGGCTGAGTT -> ACCAGGTATTACAGGGCTGAGTTT
TCGGCCAATTATACCGTGGGCTAG -> CGGCCAATTATACCGTGGGCTAGC
GTCCAGACCTGAGTATGATGGGAG -> TCCAGACCTGAGTATGATGGGAGT
ACCAGAGGGTTTACTAGCGGCGTG -> CCAGAGGGTTTACTAGCGGCGTGC
GCGGCCAGGATAGATTATAGAAGC -> CGGCCAGGATAGATTATAGAAGCA
TCGTTCGCAATGGTAGTTGTCCGA -> CGTTCGCAATGGTAGTTGTCCGAT
GGAAAGCACCGATCTTCGGCTTCA -> GAAAGCACCGATCTTCGGCTTCAT
GGAGCGTAATCCATGGGTGCATCT -> GAGCGTAATCCATGGGTGCATCTT
TGTCAGACAGACAATACCGGTGGG -> GTCAGACAGACAATACCGGTGGGA
CAGACAGACAATACCGGTGGGAAA -> AGACAGACAATACCGGTGGGAAAG
AGAGATACCACAATCAATTGGTTT -> GAGATACCACAATCAATTGGTTTT
ATTCGCTAGTACCAGAGGGTTTAC -> TTCGCTAGTACCAGAGGGTTTACT
AGGATGCAGAGATACCACAATCAA -> GGATGCAGAGATACCACAATCAAT
CTTTAACGGCATGCTGCTTTCATC -> TTTAACGGCATGCTGCTTTCATCT
CAATCAATTGGTTTTCTACCACCT -> AATCAATTGGTTTTCTACCACCTG
AGCTAACTCAGGGGCGAACCACGC -> GCTAACTCAGGGGCGAACCACGCT
CGGCCTAATACTAGTTCCTATGAG -> GGCCTAATACTAGTTCCTATGAGA
GGAGTGCGTCTGGCCAATAAATGG -> GAGTGCGTCTGGCCAATAAATGGA
GTGTTACCATTGGGATCTTGGCCA -> TGTTACCATTGGGATCTTGGCCAA
TTTGGCATTCTGCCAGTTAAATAC -> TTGGCATTCTGCCAGTTAAATACT
TATGCGATAAGGTCCATACGATCG -> ATGCGATAAGGTCCATACGATCGC
ATACGTGGGACCGGGAGAGACCGG -> TACGTGGGACCGGGAGAGACCGGA
AGATTGCGGGAAGGTATTTGCTGC -> GATTGCGGGAAGGTATTTGCTGCT
CAAGAGGTTTTGCTTATACGCGGT -> AAGAGGTTTTGCTTATACGCGGTA
AGTAACCCTTAGCAGTATAAGGCT -> GTAACCCTTAGCAGTATAAGGCTT
GAATGTTCGCGACCGTTATTGATA -> AATGTTCGCGACCGTTATTGATAC
AGAGCATATCTTCTAATCCGCGTG -> GAGCATATCTTCTAATCCGCGTGA
TCTAATATCCAACCACCCGGCGAT -> CTAATATCCAACCACCCGGCGATT
TAATGGATTAGCGAAATGTTGATT -> AATGGATTAGCGAAATGTTGATTG
CAATGAGTCAAGAGGTTTTGCTTA -> AATGAGTCAAGAGGTTTTGCTTAT
CGCGACCGTTATTGATACGTGGGA -> GCGACCGTTATTGATACGTGGGAC
GGGTGGCGGCCAGGATAGATTATA -> GGTGGCGGCCAGGATAGATTATAG
CCATCTTTTAACGCAGCCGCCGTT -> CATCTTTTAACGCAGCCGCCGTTA
GGTGGTGGGCCAGCCTTTTAAGGT -> GTGGTGGGCCAGCCTTTTAAGGTA
TTTGAGCTAACTCAGGGGCGAACC -> TTGAGCTAACTCAGGGGCGAACCA
GATGAGGCGATTTTGTCAGACAGA -> ATGAGGCGATTTTGTCAGACAGAC
GATAACTCTGCGGTGTCGGCTAGT -> ATAACTCTGCGGTGTCGGCTAGTA
TCGGTTCCGTTCAGCTTTGAGACT -> CGGTTCCGTTCAGCTTTGAGACTA
GTCAGACAGACAATACCGGTGGGA -> TCAGACAGACAATACCGGTGGGAA
CCGTCCAGACCTGAGTATGATGGG -> CGTCCAGACCTGAGTATGATGGGA
CGTGAGGGCACAATGTCCGCTAGC -> GTGAGGGCACAATGTCCGCTAGCT
ACAATCTAATATCCAACCACCCGG -> CAATCTAATATCCAACCACCCGGC
CGGAAGAGACATATTCAGGTGCCC -> GGAAGAGACATATTCAGGTGCCCA
AATACCGGTGGGAAAGCACCGATC -> ATACCGGTGGGAAAGCACCGATCT
TGGTTTTCTACCACCTGTCTCTAT -> GGTTTTCTACCACCTGTCTCTATG
AACTTTAACGGCATGCTGCTTTCA -> ACTTTAACGGCATGCTGCTTTCAT
AAGGTCCATACGATCGCACATTTT -> AGGTCCATACGATCGCACATTTTG
AGGGTCGGCCAATTATACCGTGGG -> GGGTCGGCCAATTATACCGTGGGC
GTCTAAATCCAGGCGGCAGCTGTC -> TCTAAATCCAGGCGGCAGCTGTCT
CACTATGTGTGTGGGCACGAACAA -> ACTATGTGTGTGGGCACGAACAAT
ATTCTCTCGACGGTACTACAAGGT -> TTCTCTCGACGGTACTACAAGGTG
AGCTTTAACAATATGGTCCACAAT -> GCTTTAACAATATGGTCCACAATC
TTGGCCAAGGAGCACAGTATATGT -> TGGCCAAGGAGCACAGTATATGTC
TAAATACTCGGCCATGATGCCGGA -> AAATACTCGGCCATGATGCCGGAA
GGCTGTGGTCACGGTCGGAAGAGA -> GCTGTGGTCACGGTCGGAAGAGAC
GTGGTCACGGTCGGAAGAGACATA -> TGGTCACGGTCGGAAGAGACATAT
CTACACGGCTGTGGTCACGGTCGG -> TACACGGCTGTGGTCACGGTCGGA
TGATGTGCATACTAAGCACGTGCA -> GATGTGCATACTAAGCACGTGCAG
TCCGATTATCGGTTCCGTTCAGCT -> CCGATTATCGGTTCCGTTCAGCTT
TCGGAAGAGACATCAACTTAGTAT -> CGGAAGAGACATCAACTTAGTATC
CAAGATAACTCTGCGGTGTCGGCT -> AAGATAACTCTGCGGTGTCGGCTA
TCTGCGGTGTCGGCTAGTATCGAT -> CTGCGGTGTCGGCTAGTATCGATA
TAACCTTTGAGCTAACTCAGGGGC -> AACCTTTGAGCTAACTCAGGGGCG
AATAATCCTTCTAGGCCACCAACG -> ATAATCCTTCTAGGCCACCAACGC
TTGGTTTTCTACCACCTGTCTCTA -> TGGTTTTCTACCACCTGTCTCTAT
CGTGGGACCGGGAGAGACCGGAAA -> GTGGGACCGGGAGAGACCGGAAAC
CAGTTTAGAACGTAGCCCCGCTTA -> AGTTTAGAACGTAGCCCCGCTTAG
TTTTCTACCACCTGTCTCTATGCC -> TTTCTACCACCTGTCTCTATGCCA
ATCGATAAAGTATGGCAGAACGGG -> TCGATAAAGTATGGCAGAACGGGG
CCAGCCTCGGTGGTGGGCCAGCCT -> CAGCCTCGGTGGTGGGCCAGCCTT
TTAGGCGGTCAAGCGATGCGGGGA -> TAGGCGGTCAAGCGATGCGGGGAA
CAGAGAAGCCGAGGGCTCACGGTC -> AGAGAAGCCGAGGGCTCACGGTCT
AGAGAGAACACGTGACTGGTGTAG -> GAGAGAACACGTGACTGGTGTAGG
TAGAGGGTCGGCCAATTATACCGT -> AGAGGGTCGGCCAATTATACCGTG
GCCAGTTAAATACTCGGCCATGAT -> CCAGTTAAATACTCGGCCATGATG
ATACCGTGGGCTAGCACTATGTGT -> TACCGTGGGCTAGCACTATGTGTG
ATGCGGGGAAGTTATAATACCAGA -> TGCGGGGAAGTTATAATACCAGAG
GGCTGTAGGTCTTGAACATCGGAA -> GCTGTAGGTCTTGAACATCGGAAG
TTCGCGACCGTTATTGATACGTGG -> TCGCGACCGTTATTGATACGTGGG
TTGCTTATACGCGGTAGCTGCTGT -> TGCTTATACGCGGTAGCTGCTGTA
CCTTTTAAGGTAAGCTACCAAAAA -> CTTTTAAGGTAAGCTACCAAAAAT
TCTGCTGTAATAAGTGGACCTCAT -> CTGCTGTAATAAGTGGACCTCATC
ACAGATCGACTCAGAAGTAGTTTA -> CAGATCGACTCAGAAGTAGTTTAA
GACGAGTACTGAATCGTTGTCTCC -> ACGAGTACTGAATCGTTGTCTCCT
CGTTGTTCTGTAGAGGGTCGGCCA -> GTTGTTCTGTAGAGGGTCGGCCAA
GCTTCTATACTTTAACACGGCCTA -> CTTCTATACTTTAACACGGCCTAC
AGAGGTTTTGCTTATACGCGGTAG -> GAGGTTTTGCTTATACGCGGTAGC
GGCGAACCACGCTGTCAAATTTAC -> GCGAACCACGCTGTCAAATTTACG
CGCACGACTTGAAACACAGATCGA -> GCACGACTTGAAACACAGATCGAC
TCCACGGCTACCGCAAGAAAGAGA -> CCACGGCTACCGCAAGAAAGAGAG
TCCAGGCGGCAGCTGTCTGCTGTA -> CCAGGCGGCAGCTGTCTGCTGTAA
ACTACACGGCTGTGGTCACGGTCG -> CTACACGGCTGTGGTCACGGTCGG
CTCGACGGTACTACAAGGTGCCCC -> TCGACGGTACTACAAGGTGCCCCT
CACGTTAGGAGTGCGTCTGGCCAA -> ACGTTAGGAGTGCGTCTGGCCAAT
GTAACTTTCAAGAATGTTCGCGAC -> TAACTTTCAAGAATGTTCGCGACC
CTATGCCATATGGGAAACGGCCTA -> TATGCCATATGGGAAACGGCCTAA
ATTCCATCTTTTAACGCAGCCGCC -> TTCCATCTTTTAACGCAGCCGCCG
CTGGCCAATAAATGGACTAGCCTC -> TGGCCAATAAATGGACTAGCCTCT
CGGTGCCATCGGGAAGCCACTCAG -> GGTGCCATCGGGAAGCCACTCAGA
AGGTCCATACGATCGCACATTTTG -> GGTCCATACGATCGCACATTTTGA
AGACATATTCAGGTGCCCAACCAG -> GACATATTCAGGTGCCCAACCAGG
GTACCAGAGGGTTTACTAGCGGCG -> TACCAGAGGGTTTACTAGCGGCGT
GGACTAGCCTCTCTGATGAGGCGA -> GACTAGCCTCTCTGATGAGGCGAT
CAGAGATACCACAATCAATTGGTT -> AGAGATACCACAATCAATTGGTTT
TGGACTAGCCTCTCTGATGAGGCG -> GGACTAGCCTCTCTGATGAGGCGA
GGTGCCATCGGGAAGCCACTCAGA -> GTGCCATCGGGAAGCCACTCAGAT
CACGAACAATGAGTCAAGAGGTTT -> ACGAACAATGAGTCAAGAGGTTTT
TAATGCCGATCGCGTAGGATATTA -> AATGCCGATCGCGTAGGATATTAA
GCACGACTTGAAACACAGATCGAC -> CACGACTTGAAACACAGATCGACT
AAACTTTAACGGCATGCTGCTTTC -> AACTTTAACGGCATGCTGCTTTCA
ACTCTCCGACGTCCTCGGCTGTAG -> CTCTCCGACGTCCTCGGCTGTAGG
CCTAGCGGAAGTCGATAGGTGAAT -> CTAGCGGAAGTCGATAGGTGAATA
CTGGTGTAGGAGACTGAATTTAAT -> TGGTGTAGGAGACTGAATTTAATG
AACGTAGCCCCGCTTAGACGCCGT -> ACGTAGCCCCGCTTAGACGCCGTA
TCCAAGTGGCTTAGCGCCAATGTA -> CCAAGTGGCTTAGCGCCAATGTAT
AATATCCAACCACCCGGCGATTAG -> ATATCCAACCACCCGGCGATTAGT
AACCAGGCATGTTTATCTGCTACT -> ACCAGGCATGTTTATCTGCTACTG
CCTCGGCTGTAGGTCTTGAACATC -> CTCGGCTGTAGGTCTTGAACATCG
CGTAATCCATGGGTGCATCTTCAA -> GTAATCCATGGGTGCATCTTCAAT
TAAGGTCCATACGATCGCACATTT -> AAGGTCCATACGATCGCACATTTT
TTGAAACACAGATCGACTCAGAAG -> TGAAACACAGATCGACTCAGAAGT
TGACTGGTGTAGGAGACTGAATTT -> GACTGGTGTAGGAGACTGAATTTA
TGCACACTAACGTTGTTCTGTAGA -> GCACACTAACGTTGTTCTGTAGAG
GCTTAGACGCCGTAGTAACTTTCA -> CTTAGACGCCGTAGTAACTTTCAA
CCGAGGGCTCACGGTCTAAATCCA -> CGAGGGCTCACGGTCTAAATCCAG
CCCTTAGCAGTATAAGGCTTCTAT -> CCTTAGCAGTATAAGGCTTCTATA
CACTGACCAACACGCACGACTTGA -> ACTGACCAACACGCACGACTTGAA
CCACAATCAATTGGTTTTCTACCA -> CACAATCAATTGGTTTTCTACCAC
GTATAATTCGCTAGTACCAGAGGG -> TATAATTCGCTAGTACCAGAGGGT
GAAGCCACTCAGATTGCGGGAAGG -> AAGCCACTCAGATTGCGGGAAGGT
GCAGTATAAGGCTTCTATACTTTA -> CAGTATAAGGCTTCTATACTTTAA
GTCCTCGGCTGTAGGTCTTGAACA -> TCCTCGGCTGTAGGTCTTGAACAT
CGAACAATGAGTCAAGAGGTTTTG -> GAACAATGAGTCAAGAGGTTTTGC
GTCCACGGCTACCGCAAGAAAGAG -> TCCACGGCTACCGCAAGAAAGAGA
ACCGTGGGCTAGCACTATGTGTGT -> CCGTGGGCTAGCACTATGTGTGTG
TCACTTCGCATTTATTCTCTCGAC -> CACTTCGCATTTATTCTCTCGACG
CTAAGCACGTGCAGCGTGATGACA -> TAAGCACGTGCAGCGTGATGACAA
CACCAACGCAACCAGGCATGTTTA -> ACCAACGCAACCAGGCATGTTTAT
CTTCATGCACACTAACGTTGTTCT -> TTCATGCACACTAACGTTGTTCTG
GGAAACATGTCTAGGGTGTTACCA -> GAAACATGTCTAGGGTGTTACCAT
ACGGCTGTGGTCACGGTCGGAAGA -> CGGCTGTGGTCACGGTCGGAAGAG
ATTTGGTGATCTCAGTTTAGAACG -> TTTGGTGATCTCAGTTTAGAACGT
CGACTCAGAAGTAGTTTAATGCCG -> GACTCAGAAGTAGTTTAATGCCGA
CTTTCAAGAATGTTCGCGACCGTT -> TTTCAAGAATGTTCGCGACCGTTA
CTATCGAGAAAGGAGCGTAATCCA -> TATCGAGAAAGGAGCGTAATCCAT
TTCGCAATGGTAGTTGTCCGATTA -> TCGCAATGGTAGTTGTCCGATTAT
ACCGGGAGAGACCGGAAACATGTC -> CCGGGAGAGACCGGAAACATGTCT
CAAGGTGCCCCTAACACGTTAGGA -> AAGGTGCCCCTAACACGTTAGGAG
TGTCCTATCGGACCACTAGTGTCA -> GTCCTATCGGACCACTAGTGTCAC
GTTAGGAGTGCGTCTGGCCAATAA -> TTAGGAGTGCGTCTGGCCAATAAA
TAGCTGCTGTAGACGTGGTCTCGC -> AGCTGCTGTAGACGTGGTCTCGCC
GTCGGCCAATTATACCGTGGGCTA -> TCGGCCAATTATACCGTGGGCTAG
GTATTAGGCGGTCAAGCGATGCGG -> TATTAGGCGGTCAAGCGATGCGGG
ACGTTAGGAGTGCGTCTGGCCAAT -> CGTTAGGAGTGCGTCTGGCCAATA
TATCGGACCACTAGTGTCACTAAC -> ATCGGACCACTAGTGTCACTAACC
ATCAATTGGTTTTCTACCACCTGT -> TCAATTGGTTTTCTACCACCTGTC
GCACGAACAATGAGTCAAGAGGTT -> CACGAACAATGAGTCAAGAGGTTT
TAGCTTTAACAATATGGTCCACAA -> AGCTTTAACAATATGGTCCACAAT
TATACTTTAACACGGCCTACACGG -> ATACTTTAACACGGCCTACACGGC
TACGCCACGGCGAATTTGGTGATC -> ACGCCACGGCGAATTTGGTGATCT
GGCATTCTGCCAGTTAAATACTCG -> GCATTCTGCCAGTTAAATACTCGG
TATGGTCCACAATCTAATATCCAA -> ATGGTCCACAATCTAATATCCAAC
ACGGTCTAAATCCAGGCGGCAGCT -> CGGTCTAAATCCAGGCGGCAGCTG
TAACGTTGTTCTGTAGAGGGTCGG -> AACGTTGTTCTGTAGAGGGTCGGC
AGCGGTTTGGCATTCTGCCAGTTA -> GCGGTTTGGCATTCTGCCAGTTAA
CGTATACTAAGGATGCAGAGATAC -> GTATACTAAGGATGCAGAGATACC
ATATTTATTTCGGGTGGCGGCCAG -> TATTTATTTCGGGTGGCGGCCAGG
CGGGAAGGTATTTGCTGCTATCGA -> GGGAAGGTATTTGCTGCTATCGAG
AGCACTGACCAACACGCACGACTT -> GCACTGACCAACACGCACGACTTG
CTGTAGGTCTTGAACATCGGAAGA -> TGTAGGTCTTGAACATCGGAAGAG
CCACCCGGCGATTAGTCACTTCGC -> CACCCGGCGATTAGTCACTTCGCA
GTTAACTATGCGATAAGGTCCATA -> TTAACTATGCGATAAGGTCCATAC
AATGGTAGTTGTCCGATTATCGGT -> ATGGTAGTTGTCCGATTATCGGTT
TCATCCGTCCAGACCTGAGTATGA -> CATCCGTCCAGACCTGAGTATGAT
GACGTGGTCTCGCCCCGGCCCTAG -> ACGTGGTCTCGCCCCGGCCCTAGC
AAGGTATAATTCGCTAGTACCAGA -> AGGTATAATTCGCTAGTACCAGAG
GAAGGTATAATTCGCTAGTACCAG -> AAGGTATAATTCGCTAGTACCAGA
GGACATGATTCTCTATTGACCTAT -> GACATGATTCTCTATTGACCTATG
CAGCCTCGGTGGTGGGCCAGCCTT -> AGCCTCGGTGGTGGGCCAGCCTTT
ACAATCAATTGGTTTTCTACCACC -> CAATCAATTGGTTTTCTACCACCT
TAAGGTAAGCTACCAAAAATGTAA -> AAGGTAAGCTACCAAAAATGTAAA
TACCAAAAATGTAAATTGGTGCTA -> ACCAAAAATGTAAATTGGTGCTAC
GTTCTGTAGAGGGTCGGCCAATTA -> TTCTGTAGAGGGTCGGCCAATTAT
GTACTGAATCGTTGTCTCCTCAAA -> TACTGAATCGTTGTCTCCTCAAAC
CGGGAGAGACCGGAAACATGTCTA -> GGGAGAGACCGGAAACATGTCTAG
GTGCCGTACGGATGATGCTGAATC -> TGCCGTACGGATGATGCTGAATCT
GAGAACACGTGACTGGTGTAGGAG -> AGAACACGTGACTGGTGTAGGAGA
AGAGAAGCCGAGGGCTCACGGTCT -> GAGAAGCCGAGGGCTCACGGTCTA
TGAATATTTATTTCGGGTGGCGGC -> GAATATTTATTTCGGGTGGCGGCC
GTATGTAATCCGCAATAATCCTTC -> TATGTAATCCGCAATAATCCTTCT
GGAGAACGCTGACTCTCCGACGTC -> GAGAACGCTGACTCTCCGACGTCC
TCCGCGTGAGGGCACAATGTCCGC -> CCGCGTGAGGGCACAATGTCCGCT
AGATCGACTCAGAAGTAGTTTAAT -> GATCGACTCAGAAGTAGTTTAATG
ACGCTAAAGAGGGCATACACCACG -> CGCTAAAGAGGGCATACACCACGG
AAGATTCCATCTTTTAACGCAGCC -> AGATTCCATCTTTTAACGCAGCCG
CTCTGCGGTGTCGGCTAGTATCGA -> TCTGCGGTGTCGGCTAGTATCGAT
ATAAGGCTTCTATACTTTAACACG -> TAAGGCTTCTATACTTTAACACGG
CGCTCGGCCCCGGTATGTAATCCG -> GCTCGGCCCCGGTATGTAATCCGC
ATACTAAGGATGCAGAGATACCAC -> TACTAAGGATGCAGAGATACCACA
GCTGTCTGCTGTAATAAGTGGACC -> CTGTCTGCTGTAATAAGTGGACCT
ACCAGGTATTACAGGGCTGAGTTT -> CCAGGTATTACAGGGCTGAGTTTT
CCTCGGTGGTGGGCCAGCCTTTTA -> CTCGGTGGTGGGCCAGCCTTTTAA
GCACGTGCAGCGTGATGACAAGCG -> CACGTGCAGCGTGATGACAAGCGG
GAGCACAGTATATGTCCTATCGGA -> AGCACAGTATATGTCCTATCGGAC
TTTAACGGCATGCTGCTTTCATCT -> TTAACGGCATGCTGCTTTCATCTC
AATAAATGGACTAGCCTCTCTGAT -> ATAAATGGACTAGCCTCTCTGATG
GTTCGCGACCGTTATTGATACGTG -> TTCGCGACCGTTATTGATACGTGG
CTGCTATCGAGAAAGGAGCGTAAT -> TGCTATCGAGAAAGGAGCGTAATC
CACTTCGCATTTATTCTCTCGACG -> ACTTCGCATTTATTCTCTCGACGG
TATTGACCTATGGTCAAACTTTAA -> ATTGACCTATGGTCAAACTTTAAC
TCATGCACACTAACGTTGTTCTGT -> CATGCACACTAACGTTGTTCTGTA
CTAGCTTTAACAATATGGTCCACA -> TAGCTTTAACAATATGGTCCACAA
CCTACACGGCAAGATCTTCAGCTC -> CTACACGGCAAGATCTTCAGCTCC
TGATGACAAGCGGTTTGGCATTCT -> GATGACAAGCGGTTTGGCATTCTG
ATACGCGGTAGCTGCTGTAGACGT -> TACGCGGTAGCTGCTGTAGACGTG
TTAGGAGTGCGTCTGGCCAATAAA -> TAGGAGTGCGTCTGGCCAATAAAT
TAGTCACTTCGCATTTATTCTCTC -> AGTCACTTCGCATTTATTCTCTCG
TGTCTAGGGTGTTACCATTGGGAT -> GTCTAGGGTGTTACCATTGGGATC
TTTTGACGCTAAAGAGGGCATACA -> TTTGACGCTAAAGAGGGCATACAC
TGTAATCCGCAATAATCCTTCTAG -> GTAATCCGCAATAATCCTTCTAGG
CATGCTGCTTTCATCTCCAAGTGG -> ATGCTGCTTTCATCTCCAAGTGGC
CTCAGATTGCGGGAAGGTATTTGC -> TCAGATTGCGGGAAGGTATTTGCT
CATTGGGATCTTGGCCAAGGAGCA -> ATTGGGATCTTGGCCAAGGAGCAC
CACAATCTAATATCCAACCACCCG -> ACAATCTAATATCCAACCACCCGG
CATGTTTATCTGCTACTGCCGCCA -> ATGTTTATCTGCTACTGCCGCCAA
TTTGTCAGACAGACAATACCGGTG -> TTGTCAGACAGACAATACCGGTGG
TGTCTGGCCTGGGGGTCCACGGCT -> GTCTGGCCTGGGGGTCCACGGCTA
CGGCGTGCCGTACGGATGATGCTG -> GGCGTGCCGTACGGATGATGCTGA
TTTAATGGATTAGCGAAATGTTGA -> TTAATGGATTAGCGAAATGTTGAT
GACATGATTCTCTATTGACCTATG -> ACATGATTCTCTATTGACCTATGG
ACTATGCGATAAGGTCCATACGAT -> CTATGCGATAAGGTCCATACGATC
TGCGGGAAGGTATTTGCTGCTATC -> GCGGGAAGGTATTTGCTGCTATCG
CGGCGATTAGTCACTTCGCATTTA -> GGCGATTAGTCACTTCGCATTTAT
TCTCTATGCCATATGGGAAACGGC -> CTCTATGCCATATGGGAAACGGCC
CTATACTTTAACACGGCCTACACG -> TATACTTTAACACGGCCTACACGG
CGGCTGTAGGTCTTGAACATCGGA -> GGCTGTAGGTCTTGAACATCGGAA
AAGAGAGAACACGTGACTGGTGTA -> AGAGAGAACACGTGACTGGTGTAG
GGAAGTCGATAGGTGAATATTTAT -> GAAGTCGATAGGTGAATATTTATT
TGGGTGCATCTTCAATTTCCAAGA -> GGGTGCATCTTCAATTTCCAAGAT
GCCAAGGAGCACAGTATATGTCCT -> CCAAGGAGCACAGTATATGTCCTA
AATATTTATTTCGGGTGGCGGCCA -> ATATTTATTTCGGGTGGCGGCCAG
TAATCCGCGTGAGGGCACAATGTC -> AATCCGCGTGAGGGCACAATGTCC
GCGTGAGGGCACAATGTCCGCTAG -> CGTGAGGGCACAATGTCCGCTAGC
GCAGCCGCCGTTAACTATGCGATA -> CAGCCGCCGTTAACTATGCGATAA
CCACCAACGCAACCAGGCATGTTT -> CACCAACGCAACCAGGCATGTTTA
CCAAGTGGCTTAGCGCCAATGTAT -> CAAGTGGCTTAGCGCCAATGTATT
GCACTGACCAACACGCACGACTTG -> CACTGACCAACACGCACGACTTGA
GTTCCGTTCAGCTTTGAGACTACA -> TTCCGTTCAGCTTTGAGACTACAA
GCCTCGGTGGTGGGCCAGCCTTTT -> CCTCGGTGGTGGGCCAGCCTTTTA
GAGTTGTGCTTAGGGGGACATGAT -> AGTTGTGCTTAGGGGGACATGATT
TTTTGTCAGACAGACAATACCGGT -> TTTGTCAGACAGACAATACCGGTG
GCATTCTGCCAGTTAAATACTCGG -> CATTCTGCCAGTTAAATACTCGGC
ATTGGTTTTCTACCACCTGTCTCT -> TTGGTTTTCTACCACCTGTCTCTA
ATGGACTAGCCTCTCTGATGAGGC -> TGGACTAGCCTCTCTGATGAGGCG
ACGAACAATGAGTCAAGAGGTTTT -> CGAACAATGAGTCAAGAGGTTTTG
TCGCGTAGGATATTAAACTACACG -> CGCGTAGGATATTAAACTACACGG
CGACTTGAAACACAGATCGACTCA -> GACTTGAAACACAGATCGACTCAG
TGTCACTAACCTTTGAGCTAACTC -> GTCACTAACCTTTGAGCTAACTCA
CAATGGTAGTTGTCCGATTATCGG -> AATGGTAGTTGTCCGATTATCGGT
CCGGGAGAGACCGGAAACATGTCT -> CGGGAGAGACCGGAAACATGTCTA
AGTCACTTCGCATTTATTCTCTCG -> GTCACTTCGCATTTATTCTCTCGA
GACATCAACTTAGTATCTGTCTGG -> ACATCAACTTAGTATCTGTCTGGC
CGATTTTGTCAGACAGACAATACC -> GATTTTGTCAGACAGACAATACCG
AACCACCCGGCGATTAGTCACTTC -> ACCACCCGGCGATTAGTCACTTCG
TCGGACCACTAGTGTCACTAACCT -> CGGACCACTAGTGTCACTAACCTT
ATTGACCTATGGTCAAACTTTAAC -> TTGACCTATGGTCAAACTTTAACG
GGTAAGCTACCAAAAATGTAAATT -> GTAAGCTACCAAAAATGTAAATTG
TTTATCTGCTACTGCCGCCAAGAT -> TTATCTGCTACTGCCGCCAAGATT
AGAAAGAGAGAACACGTGACTGGT -> GAAAGAGAGAACACGTGACTGGTG
GATGCGGGGAAGTTATAATACCAG -> ATGCGGGGAAGTTATAATACCAGA
TCTAGGGTGTTACCATTGGGATCT -> CTAGGGTGTTACCATTGGGATCTT
ACTTTAACGGCATGCTGCTTTCAT -> CTTTAACGGCATGCTGCTTTCATC
AATCCTTCTAGGCCACCAACGCAA -> ATCCTTCTAGGCCACCAACGCAAC
GTGCATCTTCAATTTCCAAGATAA -> TGCATCTTCAATTTCCAAGATAAC
TGGGAGTAACCCTTAGCAGTATAA -> GGGAGTAACCCTTAGCAGTATAAG
TAGCACTATGTGTGTGGGCACGAA -> AGCACTATGTGTGTGGGCACGAAC
TACACCACGGAGAACGCTGACTCT -> ACACCACGGAGAACGCTGACTCTC
CATCGGGAAGCCACTCAGATTGCG -> ATCGGGAAGCCACTCAGATTGCGG
CCCGGCCCTAGCGGAAGTCGATAG -> CCGGCCCTAGCGGAAGTCGATAGG
TAGTACCAGAGGGTTTACTAGCGG -> AGTACCAGAGGGTTTACTAGCGGC
GAGATACCACAATCAATTGGTTTT -> AGATACCACAATCAATTGGTTTTC
TGATCTCAGTTTAGAACGTAGCCC -> GATCTCAGTTTAGAACGTAGCCCC
TCGACGGTACTACAAGGTGCCCCT -> CGACGGTACTACAAGGTGCCCCTA
ACAGACAATACCGGTGGGAAAGCA -> CAGACAATACCGGTGGGAAAGCAC
TCGCGACCGTTATTGATACGTGGG -> CGCGACCGTTATTGATACGTGGGA
GGCCTAATACTAGTTCCTATGAGA -> GCCTAATACTAGTTCCTATGAGAG
CTTCTAGGCCACCAACGCAACCAG -> TTCTAGGCCACCAACGCAACCAGG
TGCATACTAAGCACGTGCAGCGTG -> GCATACTAAGCACGTGCAGCGTGA
GCATACACCACGGAGAACGCTGAC -> CATACACCACGGAGAACGCTGACT
ACCTATGGTCAAACTTTAACGGCA -> CCTATGGTCAAACTTTAACGGCAT
CGGTACTACAAGGTGCCCCTAACA -> GGTACTACAAGGTGCCCCTAACAC
CCAATAAATGGACTAGCCTCTCTG -> CAATAAATGGACTAGCCTCTCTGA
ATCTTGGCCAAGGAGCACAGTATA -> TCTTGGCCAAGGAGCACAGTATAT
AACATGTCTAGGGTGTTACCATTG -> ACATGTCTAGGGTGTTACCATTGG
GAAGAGACATCAACTTAGTATCTG -> AAGAGACATCAACTTAGTATCTGT
GAAGTCGATAGGTGAATATTTATT -> AAGTCGATAGGTGAATATTTATTT
AGGTCTTGAACATCGGAAGAGACA -> GGTCTTGAACATCGGAAGAGACAT
TCGGCTTCATGCACACTAACGTTG -> CGGCTTCATGCACACTAACGTTGT
AGATACCACAATCAATTGGTTTTC -> GATACCACAATCAATTGGTTTTCT
TTCTATACTTTAACACGGCCTACA -> TCTATACTTTAACACGGCCTACAC
GGTTTTCTACCACCTGTCTCTATG -> GTTTTCTACCACCTGTCTCTATGC
TTCAGCTCCGGAGGCGTTGGAGAC -> TCAGCTCCGGAGGCGTTGGAGACG
AACAACTTGAGTTGTGCTTAGGGG -> ACAACTTGAGTTGTGCTTAGGGGG
GCGATTAGTCACTTCGCATTTATT -> CGATTAGTCACTTCGCATTTATTC
TGTCCGCTAGCTTTAACAATATGG -> GTCCGCTAGCTTTAACAATATGGT
ATGGATTAGCGAAATGTTGATTGC -> TGGATTAGCGAAATGTTGATTGCG
CTACACGGCAAGATCTTCAGCTCC -> TACACGGCAAGATCTTCAGCTCCG
GCCAAGATTCCATCTTTTAACGCA -> CCAAGATTCCATCTTTTAACGCAG
TCAGCTTTGAGACTACAAGCGGTA -> CAGCTTTGAGACTACAAGCGGTAT
ATTATAGAAGCACTGACCAACACG -> TTATAGAAGCACTGACCAACACGC
CCTATCGGACCACTAGTGTCACTA -> CTATCGGACCACTAGTGTCACTAA
TCAGAAGTAGTTTAATGCCGATCG -> CAGAAGTAGTTTAATGCCGATCGC
CAAGCGGTATGCGATGACGAGTAC -> AAGCGGTATGCGATGACGAGTACT
GTGATCTCAGTTTAGAACGTAGCC -> TGATCTCAGTTTAGAACGTAGCCC
TTTAAGGTAAGCTACCAAAAATGT -> TTAAGGTAAGCTACCAAAAATGTA
TTCTAGGCCACCAACGCAACCAGG -> TCTAGGCCACCAACGCAACCAGGC
ATATTCAGGTGCCCAACCAGGTAT -> TATTCAGGTGCCCAACCAGGTATT
GTAGGTCTTGAACATCGGAAGAGA -> TAGGTCTTGAACATCGGAAGAGAC
GCCACCAACGCAACCAGGCATGTT -> CCACCAACGCAACCAGGCATGTTT
ATGCCGGAAGGTATAATTCGCTAG -> TGCCGGAAGGTATAATTCGCTAGT
CTCGCCCCGGCCCTAGCGGAAGTC -> TCGCCCCGGCCCTAGCGGAAGTCG
GATCGCGTAGGATATTAAACTACA -> ATCGCGTAGGATATTAAACTACAC
CTTCTAATCCGCGTGAGGGCACAA -> TTCTAATCCGCGTGAGGGCACAAT
TGTTGATTGCGGGCCCAGCCTCGG -> GTTGATTGCGGGCCCAGCCTCGGT
CTTCAATTTCCAAGATAACTCTGC -> TTCAATTTCCAAGATAACTCTGCG
ACACCACGGAGAACGCTGACTCTC -> CACCACGGAGAACGCTGACTCTCC
ATCGAGAAAGGAGCGTAATCCATG -> TCGAGAAAGGAGCGTAATCCATGG
GGCCCAGCCTCGGTGGTGGGCCAG -> GCCCAGCCTCGGTGGTGGGCCAGC
GAGACATCAACTTAGTATCTGTCT -> AGACATCAACTTAGTATCTGTCTG
ATCCATGGGTGCATCTTCAATTTC -> TCCATGGGTGCATCTTCAATTTCC
GCCTGGGGGTCCACGGCTACCGCA -> CCTGGGGGTCCACGGCTACCGCAA
CGGCAGCTGTCTGCTGTAATAAGT -> GGCAGCTGTCTGCTGTAATAAGTG
CTGAATTTAATGGATTAGCGAAAT -> TGAATTTAATGGATTAGCGAAATG
GATCTTCGGCTTCATGCACACTAA -> ATCTTCGGCTTCATGCACACTAAC
AGGTATAATTCGCTAGTACCAGAG -> GGTATAATTCGCTAGTACCAGAGG
CGAAATGTTGATTGCGGGCCCAGC -> GAAATGTTGATTGCGGGCCCAGCC
CTTCAGCTCCGGAGGCGTTGGAGA -> TTCAGCTCCGGAGGCGTTGGAGAC
AAGTGGCTTAGCGCCAATGTATTA -> AGTGGCTTAGCGCCAATGTATTAG
AGCCTCGGTGGTGGGCCAGCCTTT -> GCCTCGGTGGTGGGCCAGCCTTTT
TGCTTAGGGGGACATGATTCTCTA -> GCTTAGGGGGACATGATTCTCTAT
CTAACTCAGGGGCGAACCACGCTG -> TAACTCAGGGGCGAACCACGCTGT
TTCTCTATTGACCTATGGTCAAAC -> TCTCTATTGACCTATGGTCAAACT
ATTATCGGTTCCGTTCAGCTTTGA -> TTATCGGTTCCGTTCAGCTTTGAG
GTCTAGGGTGTTACCATTGGGATC -> TCTAGGGTGTTACCATTGGGATCT
TACTCGGCCATGATGCCGGAAGGT -> ACTCGGCCATGATGCCGGAAGGTA
TCCGGAGGCGTTGGAGACGGTGCC -> CCGGAGGCGTTGGAGACGGTGCCA
AATGTAAATTGGTGCTACGCCACG -> ATGTAAATTGGTGCTACGCCACGG
GGCGGTCAAGCGATGCGGGGAAGT -> GCGGTCAAGCGATGCGGGGAAGTT
TTAACGGCATGCTGCTTTCATCTC -> TAACGGCATGCTGCTTTCATCTCC
TTGAACATCGGAAGAGACATCAAC -> TGAACATCGGAAGAGACATCAACT
AACTCAGGGGCGAACCACGCTGTC -> ACTCAGGGGCGAACCACGCTGTCA
AACGGGGAGTGATGTGCATACTAA -> ACGGGGAGTGATGTGCATACTAAG
GTTGTTCTGTAGAGGGTCGGCCAA -> TTGTTCTGTAGAGGGTCGGCCAAT
ATGTATTAGGCGGTCAAGCGATGC -> TGTATTAGGCGGTCAAGCGATGCG
CCTAACACGTTAGGAGTGCGTCTG -> CTAACACGTTAGGAGTGCGTCTGG
AATATGGTCCACAATCTAATATCC -> ATATGGTCCACAATCTAATATCCA
TCGCTAGTACCAGAGGGTTTACTA -> CGCTAGTACCAGAGGGTTTACTAG
TGGGCACGAACAATGAGTCAAGAG -> GGGCACGAACAATGAGTCAAGAGG
CATCTTTTAACGCAGCCGCCGTTA -> ATCTTTTAACGCAGCCGCCGTTAA
CATCGGAAGAGACATCAACTTAGT -> ATCGGAAGAGACATCAACTTAGTA
CTGACCAACACGCACGACTTGAAA -> TGACCAACACGCACGACTTGAAAC
CCACGCTGTCAAATTTACGCAGTG -> CACGCTGTCAAATTTACGCAGTGC
GAGGGCTCACGGTCTAAATCCAGG -> AGGGCTCACGGTCTAAATCCAGGC
TGCCCAACCAGGTATTACAGGGCT -> GCCCAACCAGGTATTACAGGGCTG
TTTGGTGATCTCAGTTTAGAACGT -> TTGGTGATCTCAGTTTAGAACGTA
GGATGATGCTGAATCTAGTGCGCT -> GATGATGCTGAATCTAGTGCGCTC
AGACGGTGCCATCGGGAAGCCACT -> GACGGTGCCATCGGGAAGCCACTC
ATATGTCCTATCGGACCACTAGTG -> TATGTCCTATCGGACCACTAGTGT
ACTTTCAAGAATGTTCGCGACCGT -> CTTTCAAGAATGTTCGCGACCGTT
GTGGTCTCGCCCCGGCCCTAGCGG -> TGGTCTCGCCCCGGCCCTAGCGGA
ATTATACCGTGGGCTAGCACTATG -> TTATACCGTGGGCTAGCACTATGT
GTGAATATTTATTTCGGGTGGCGG -> TGAATATTTATTTCGGGTGGCGGC
TCGGAAGAGACATATTCAGGTGCC -> CGGAAGAGACATATTCAGGTGCCC
ACTGCCGCCAAGATTCCATCTTTT -> CTGCCGCCAAGATTCCATCTTTTA
ACTGGTGTAGGAGACTGAATTTAA -> CTGGTGTAGGAGACTGAATTTAAT
GGTGGCGGCCAGGATAGATTATAG -> GTGGCGGCCAGGATAGATTATAGA
ATCTCCAAGTGGCTTAGCGCCAAT -> TCTCCAAGTGGCTTAGCGCCAATG
CGCGTAGGATATTAAACTACACGG -> GCGTAGGATATTAAACTACACGGC
TGAATTTAATGGATTAGCGAAATG -> GAATTTAATGGATTAGCGAAATGT
AAACGGCCTAATACTAGTTCCTAT -> AACGGCCTAATACTAGTTCCTATG
AAGTAGTTTAATGCCGATCGCGTA -> AGTAGTTTAATGCCGATCGCGTAG
GGAAGCCACTCAGATTGCGGGAAG -> GAAGCCACTCAGATTGCGGGAAGG
TGTCGGCTAGTATCGATAAAGTAT -> GTCGGCTAGTATCGATAAAGTATG
GCTATCGAGAAAGGAGCGTAATCC -> CTATCGAGAAAGGAGCGTAATCCA
CAACTTAGTATCTGTCTGGCCTGG -> AACTTAGTATCTGTCTGGCCTGGG
GATGACAAGCGGTTTGGCATTCTG -> ATGACAAGCGGTTTGGCATTCTGC
CTGCTTTCATCTCCAAGTGGCTTA -> TGCTTTCATCTCCAAGTGGCTTAG
ATCGGGAAGCCACTCAGATTGCGG -> TCGGGAAGCCACTCAGATTGCGGG
ATTTGCTGCTATCGAGAAAGGAGC -> TTTGCTGCTATCGAGAAAGGAGCG
ATTAGCGAAATGTTGATTGCGGGC -> TTAGCGAAATGTTGATTGCGGGCC
CCGGAGGCGTTGGAGACGGTGCCA -> CGGAGGCGTTGGAGACGGTGCCAT
GAGTATGATGGGAGTAACCCTTAG -> AGTATGATGGGAGTAACCCTTAGC
AAATGTAAATTGGTGCTACGCCAC -> AATGTAAATTGGTGCTACGCCACG
CACAATCAATTGGTTTTCTACCAC -> ACAATCAATTGGTTTTCTACCACC
GAGTTTTCGTTCGCAATGGTAGTT -> AGTTTTCGTTCGCAATGGTAGTTG
TCTCCGACGTCCTCGGCTGTAGGT -> CTCCGACGTCCTCGGCTGTAGGTC
AGCCACTCAGATTGCGGGAAGGTA -> GCCACTCAGATTGCGGGAAGGTAT
GGCTAGTATCGATAAAGTATGGCA -> GCTAGTATCGATAAAGTATGGCAG
TAGGATATTAAACTACACGGCTGT -> AGGATATTAAACTACACGGCTGTG
AGATCTTCAGCTCCGGAGGCGTTG -> GATCTTCAGCTCCGGAGGCGTTGG
GGGGAGTGATGTGCATACTAAGCA -> GGGAGTGATGTGCATACTAAGCAC
AGGCATGTTTATCTGCTACTGCCG -> GGCATGTTTATCTGCTACTGCCGC
TTGACCTATGGTCAAACTTTAACG -> TGACCTATGGTCAAACTTTAACGG
AACTACACGGCTGTGGTCACGGTC -> ACTACACGGCTGTGGTCACGGTCG
GATTCCATCTTTTAACGCAGCCGC -> ATTCCATCTTTTAACGCAGCCGCC
CCAAAAATGTAAATTGGTGCTACG -> CAAAAATGTAAATTGGTGCTACGC
GAGAACGCTGACTCTCCGACGTCC -> AGAACGCTGACTCTCCGACGTCCT
GAAGGTATTTGCTGCTATCGAGAA -> AAGGTATTTGCTGCTATCGAGAAA
GTGACTGGTGTAGGAGACTGAATT -> TGACTGGTGTAGGAGACTGAATTT
AGCCTTTTAAGGTAAGCTACCAAA -> GCCTTTTAAGGTAAGCTACCAAAA
ATGCGATAAGGTCCATACGATCGC -> TGCGATAAGGTCCATACGATCGCA
CGGAAGTCGATAGGTGAATATTTA -> GGAAGTCGATAGGTGAATATTTAT
GCTGTGGTCACGGTCGGAAGAGAC -> CTGTGGTCACGGTCGGAAGAGACA
GCATACTAAGCACGTGCAGCGTGA -> CATACTAAGCACGTGCAGCGTGAT
GCTAGTATCGATAAAGTATGGCAG -> CTAGTATCGATAAAGTATGGCAGA
TGGTCACGGTCGGAAGAGACATAT -> GGTCACGGTCGGAAGAGACATATT
CCATATGGGAAACGGCCTAATACT -> CATATGGGAAACGGCCTAATACTA
TACTAAGCACGTGCAGCGTGATGA -> ACTAAGCACGTGCAGCGTGATGAC
CCGATCTTCGGCTTCATGCACACT -> CGATCTTCGGCTTCATGCACACTA
GCCACGGCGAATTTGGTGATCTCA -> CCACGGCGAATTTGGTGATCTCAG
GACTGAATTTAATGGATTAGCGAA -> ACTGAATTTAATGGATTAGCGAAA
CTTATACGCGGTAGCTGCTGTAGA -> TTATACGCGGTAGCTGCTGTAGAC
CTATGTGTGTGGGCACGAACAATG -> TATGTGTGTGGGCACGAACAATGA
CCGTTAACTATGCGATAAGGTCCA -> CGTTAACTATGCGATAAGGTCCAT
ACGCGGTAGCTGCTGTAGACGTGG -> CGCGGTAGCTGCTGTAGACGTGGT
TATTCAGGTGCCCAACCAGGTATT -> ATTCAGGTGCCCAACCAGGTATTA
GGGATCTTGGCCAAGGAGCACAGT -> GGATCTTGGCCAAGGAGCACAGTA
GTGCGTCTGGCCAATAAATGGACT -> TGCGTCTGGCCAATAAATGGACTA
TTCTGCCAGTTAAATACTCGGCCA -> TCTGCCAGTTAAATACTCGGCCAT
CGGAAACATGTCTAGGGTGTTACC -> GGAAACATGTCTAGGGTGTTACCA
CACAGTATATGTCCTATCGGACCA -> ACAGTATATGTCCTATCGGACCAC
CACATTTTGACGCTAAAGAGGGCA -> ACATTTTGACGCTAAAGAGGGCAT
AAGAGGGCATACACCACGGAGAAC -> AGAGGGCATACACCACGGAGAACG
ATGTCCGCTAGCTTTAACAATATG -> TGTCCGCTAGCTTTAACAATATGG
TGTGTGGGCACGAACAATGAGTCA -> GTGTGGGCACGAACAATGAGTCAA
TTGGTGATCTCAGTTTAGAACGTA -> TGGTGATCTCAGTTTAGAACGTAG
TATCTGTCTGGCCTGGGGGTCCAC -> ATCTGTCTGGCCTGGGGGTCCACG
GTCAAGAGGTTTTGCTTATACGCG -> TCAAGAGGTTTTGCTTATACGCGG
ATTACAGGGCTGAGTTTTCGTTCG -> TTACAGGGCTGAGTTTTCGTTCGC
TGGCTTAGCGCCAATGTATTAGGC -> GGCTTAGCGCCAATGTATTAGGCG
GAGCTAACTCAGGGGCGAACCACG -> AGCTAACTCAGGGGCGAACCACGC
CGGTATGTAATCCGCAATAATCCT -> GGTATGTAATCCGCAATAATCCTT
TACCAGAGAAGCCGAGGGCTCACG -> ACCAGAGAAGCCGAGGGCTCACGG
CTCGGCCATGATGCCGGAAGGTAT -> TCGGCCATGATGCCGGAAGGTATA
TGTAGACGTGGTCTCGCCCCGGCC -> GTAGACGTGGTCTCGCCCCGGCCC
TAGTATCTGTCTGGCCTGGGGGTC -> AGTATCTGTCTGGCCTGGGGGTCC
CGATGCGGGGAAGTTATAATACCA -> GATGCGGGGAAGTTATAATACCAG
TGTGTGTGGGCACGAACAATGAGT -> GTGTGTGGGCACGAACAATGAGTC
GGCCCCGGTATGTAATCCGCAATA -> GCCCCGGTATGTAATCCGCAATAA
GCAACCAGGCATGTTTATCTGCTA -> CAACCAGGCATGTTTATCTGCTAC
CATGGGTGCATCTTCAATTTCCAA -> ATGGGTGCATCTTCAATTTCCAAG
ACTGACCAACACGCACGACTTGAA -> CTGACCAACACGCACGACTTGAAA
CGTGGGCTAGCACTATGTGTGTGG -> GTGGGCTAGCACTATGTGTGTGGG
AATCTAATATCCAACCACCCGGCG -> ATCTAATATCCAACCACCCGGCGA
TCACGGTCGGAAGAGACATATTCA -> CACGGTCGGAAGAGACATATTCAG
CGGATGATGCTGAATCTAGTGCGC -> GGATGATGCTGAATCTAGTGCGCT
GTTGATTGCGGGCCCAGCCTCGGT -> TTGATTGCGGGCCCAGCCTCGGTG
AATAAGTGGACCTCATCCGTCCAG -> ATAAGTGGACCTCATCCGTCCAGA
CACCTGTCTCTATGCCATATGGGA -> ACCTGTCTCTATGCCATATGGGAA
CCATTGGGATCTTGGCCAAGGAGC -> CATTGGGATCTTGGCCAAGGAGCA
ATGGGTGCATCTTCAATTTCCAAG -> TGGGTGCATCTTCAATTTCCAAGA
CGATAAGGTCCATACGATCGCACA -> GATAAGGTCCATACGATCGCACAT
GAGTGATGTGCATACTAAGCACGT -> AGTGATGTGCATACTAAGCACGTG
ATGTAAATTGGTGCTACGCCACGG -> TGTAAATTGGTGCTACGCCACGGC
GAAGTTATAATACCAGAGAAGCCG -> AAGTTATAATACCAGAGAAGCCGA
TGCGCTCGGCCCCGGTATGTAATC -> GCGCTCGGCCCCGGTATGTAATCC
AGGGGGACATGATTCTCTATTGAC -> GGGGGACATGATTCTCTATTGACC
AAACACAGATCGACTCAGAAGTAG -> AACACAGATCGACTCAGAAGTAGT
GGAAACGGCCTAATACTAGTTCCT -> GAAACGGCCTAATACTAGTTCCTA
AGTATGGCAGAACGGGGAGTGATG -> GTATGGCAGAACGGGGAGTGATGT
CTCAGTTTAGAACGTAGCCCCGCT -> TCAGTTTAGAACGTAGCCCCGCTT
CGCCGTTAACTATGCGATAAGGTC -> GCCGTTAACTATGCGATAAGGTCC
TTTCATCTCCAAGTGGCTTAGCGC -> TTCATCTCCAAGTGGCTTAGCGCC
TGCGATAAGGTCCATACGATCGCA -> GCGATAAGGTCCATACGATCGCAC
ACGGCATGCTGCTTTCATCTCCAA -> CGGCATGCTGCTTTCATCTCCAAG
CGGCCAGGATAGATTATAGAAGCA -> GGCCAGGATAGATTATAGAAGCAC
AGGCCACCAACGCAACCAGGCATG -> GGCCACCAACGCAACCAGGCATGT
CCAGTTAAATACTCGGCCATGATG -> CAGTTAAATACTCGGCCATGATGC
GGCGGCAGCTGTCTGCTGTAATAA -> GCGGCAGCTGTCTGCTGTAATAAG
GCCCCTAACACGTTAGGAGTGCGT -> CCCCTAACACGTTAGGAGTGCGTC
GATGATGCTGAATCTAGTGCGCTC -> ATGATGCTGAATCTAGTGCGCTCG
TACCACAATCAATTGGTTTTCTAC -> ACCACAATCAATTGGTTTTCTACC
AGAACACGTGACTGGTGTAGGAGA -> GAACACGTGACTGGTGTAGGAGAC
GAAACATGTCTAGGGTGTTACCAT -> AAACATGTCTAGGGTGTTACCATT
GCGAAATGTTGATTGCGGGCCCAG -> CGAAATGTTGATTGCGGGCCCAGC
GGCATACACCACGGAGAACGCTGA -> GCATACACCACGGAGAACGCTGAC
GATCGACTCAGAAGTAGTTTAATG -> ATCGACTCAGAAGTAGTTTAATGC
AATCCAGGCGGCAGCTGTCTGCTG -> ATCCAGGCGGCAGCTGTCTGCTGT
TATAGAAGCACTGACCAACACGCA -> ATAGAAGCACTGACCAACACGCAC
ACTACAAGCGGTATGCGATGACGA -> CTACAAGCGGTATGCGATGACGAG
GTGAGGGCACAATGTCCGCTAGCT -> TGAGGGCACAATGTCCGCTAGCTT
GCGATGCGGGGAAGTTATAATACC -> CGATGCGGGGAAGTTATAATACCA
ATAATACCAGAGAAGCCGAGGGCT -> TAATACCAGAGAAGCCGAGGGCTC
ACGTGACTGGTGTAGGAGACTGAA -> CGTGACTGGTGTAGGAGACTGAAT
GATGCCGGAAGGTATAATTCGCTA -> ATGCCGGAAGGTATAATTCGCTAG
AGGTAAGCTACCAAAAATGTAAAT -> GGTAAGCTACCAAAAATGTAAATT
AGGCGGCAGCTGTCTGCTGTAATA -> GGCGGCAGCTGTCTGCTGTAATAA
GGGTCGGCCAATTATACCGTGGGC -> GGTCGGCCAATTATACCGTGGGCT
TTATTCTCTCGACGGTACTACAAG -> TATTCTCTCGACGGTACTACAAGG
CGATAGGTGAATATTTATTTCGGG -> GATAGGTGAATATTTATTTCGGGT
ACATTTTGACGCTAAAGAGGGCAT -> CATTTTGACGCTAAAGAGGGCATA
GCTTAGCGCCAATGTATTAGGCGG -> CTTAGCGCCAATGTATTAGGCGGT
GGTGCATCTTCAATTTCCAAGATA -> GTGCATCTTCAATTTCCAAGATAA
GTATAAGGCTTCTATACTTTAACA -> TATAAGGCTTCTATACTTTAACAC
AACACGTGACTGGTGTAGGAGACT -> ACACGTGACTGGTGTAGGAGACTG
GTCTGCTGTAATAAGTGGACCTCA -> TCTGCTGTAATAAGTGGACCTCAT
GCGTTGGAGACGGTGCCATCGGGA -> CGTTGGAGACGGTGCCATCGGGAA
GCTTCATGCACACTAACGTTGTTC -> CTTCATGCACACTAACGTTGTTCT
TACAAGGTGCCCCTAACACGTTAG -> ACAAGGTGCCCCTAACACGTTAGG
CTTCGCATTTATTCTCTCGACGGT -> TTCGCATTTATTCTCTCGACGGTA
TGAGTTTTCGTTCGCAATGGTAGT -> GAGTTTTCGTTCGCAATGGTAGTT
AACACGCACGACTTGAAACACAGA -> ACACGCACGACTTGAAACACAGAT
TCGGCCATGATGCCGGAAGGTATA -> CGGCCATGATGCCGGAAGGTATAA
GCCGCCAAGATTCCATCTTTTAAC -> CCGCCAAGATTCCATCTTTTAACG
CGTTAGGAGTGCGTCTGGCCAATA -> GTTAGGAGTGCGTCTGGCCAATAA
AGAGACCGGAAACATGTCTAGGGT -> GAGACCGGAAACATGTCTAGGGTG
GGATCTTGGCCAAGGAGCACAGTA -> GATCTTGGCCAAGGAGCACAGTAT
TCTGTCTGGCCTGGGGGTCCACGG -> CTGTCTGGCCTGGGGGTCCACGGC
CATATTCAGGTGCCCAACCAGGTA -> ATATTCAGGTGCCCAACCAGGTAT
CGATCGCACATTTTGACGCTAAAG -> GATCGCACATTTTGACGCTAAAGA
ACGGCCTAATACTAGTTCCTATGA -> CGGCCTAATACTAGTTCCTATGAG
GGTATTACAGGGCTGAGTTTTCGT -> GTATTACAGGGCTGAGTTTTCGTT
AGAAGCACTGACCAACACGCACGA -> GAAGCACTGACCAACACGCACGAC
ACGCTGACTCTCCGACGTCCTCGG -> CGCTGACTCTCCGACGTCCTCGGC
ACTTAGTATCTGTCTGGCCTGGGG -> CTTAGTATCTGTCTGGCCTGGGGG
AATCCGCGTGAGGGCACAATGTCC -> ATCCGCGTGAGGGCACAATGTCCG
GCAAGATCTTCAGCTCCGGAGGCG -> CAAGATCTTCAGCTCCGGAGGCGT
ATTAGGCGGTCAAGCGATGCGGGG -> TTAGGCGGTCAAGCGATGCGGGGA
CGTCTGGCCAATAAATGGACTAGC -> GTCTGGCCAATAAATGGACTAGCC
GCCTACACGGCAAGATCTTCAGCT -> CCTACACGGCAAGATCTTCAGCTC
CCAGGTATTACAGGGCTGAGTTTT -> CAGGTATTACAGGGCTGAGTTTTC
GTCTCTATGCCATATGGGAAACGG -> TCTCTATGCCATATGGGAAACGGC
CTGCCAGTTAAATACTCGGCCATG -> TGCCAGTTAAATACTCGGCCATGA
GAGCATATCTTCTAATCCGCGTGA -> AGCATATCTTCTAATCCGCGTGAG
AAGCGGTATGCGATGACGAGTACT -> AGCGGTATGCGATGACGAGTACTG
TGAGGCGATTTTGTCAGACAGACA -> GAGGCGATTTTGTCAGACAGACAA
TGGACCTCATCCGTCCAGACCTGA -> GGACCTCATCCGTCCAGACCTGAG
AGCTTTGAGACTACAAGCGGTATG -> GCTTTGAGACTACAAGCGGTATGC
AGACTACAAGCGGTATGCGATGAC -> GACTACAAGCGGTATGCGATGACG
ACACGGCCTACACGGCAAGATCTT -> CACGGCCTACACGGCAAGATCTTC
TGGTCTCGCCCCGGCCCTAGCGGA -> GGTCTCGCCCCGGCCCTAGCGGAA
AATACCAGAGAAGCCGAGGGCTCA -> ATACCAGAGAAGCCGAGGGCTCAC
CGCAAGAAAGAGAGAACACGTGAC -> GCAAGAAAGAGAGAACACGTGACT
AAATCCAGGCGGCAGCTGTCTGCT -> AATCCAGGCGGCAGCTGTCTGCTG
CCGTTATTGATACGTGGGACCGGG -> CGTTATTGATACGTGGGACCGGGA
CATTTATTCTCTCGACGGTACTAC -> ATTTATTCTCTCGACGGTACTACA
CCACTAGTGTCACTAACCTTTGAG -> CACTAGTGTCACTAACCTTTGAGC
CCGCAATAATCCTTCTAGGCCACC -> CGCAATAATCCTTCTAGGCCACCA
GAGTCAAGAGGTTTTGCTTATACG -> AGTCAAGAGGTTTTGCTTATACGC
CAGCCGCCGTTAACTATGCGATAA -> AGCCGCCGTTAACTATGCGATAAG
ACACGTTAGGAGTGCGTCTGGCCA -> CACGTTAGGAGTGCGTCTGGCCAA
CAAACAACTTGAGTTGTGCTTAGG -> AAACAACTTGAGTTGTGCTTAGGG
GCCCAACCAGGTATTACAGGGCTG -> CCCAACCAGGTATTACAGGGCTGA
CAGCTTTGAGACTACAAGCGGTAT -> AGCTTTGAGACTACAAGCGGTATG
CCTATGGTCAAACTTTAACGGCAT -> CTATGGTCAAACTTTAACGGCATG
ATTTCGGGTGGCGGCCAGGATAGA -> TTTCGGGTGGCGGCCAGGATAGAT
GGCCAATAAATGGACTAGCCTCTC -> GCCAATAAATGGACTAGCCTCTCT
ATCTTCAATTTCCAAGATAACTCT -> TCTTCAATTTCCAAGATAACTCTG
GGGCACAATGTCCGCTAGCTTTAA -> GGCACAATGTCCGCTAGCTTTAAC
ATCGGTTCCGTTCAGCTTTGAGAC -> TCGGTTCCGTTCAGCTTTGAGACT
AAGAGGTTTTGCTTATACGCGGTA -> AGAGGTTTTGCTTATACGCGGTAG
GCCATCGGGAAGCCACTCAGATTG -> CCATCGGGAAGCCACTCAGATTGC
AAAGTATGGCAGAACGGGGAGTGA -> AAGTATGGCAGAACGGGGAGTGAT
CGTTGTCTCCTCAAACAACTTGAG -> GTTGTCTCCTCAAACAACTTGAGT
TGGCCAATAAATGGACTAGCCTCT -> GGCCAATAAATGGACTAGCCTCTC
GCAGAGATACCACAATCAATTGGT -> CAGAGATACCACAATCAATTGGTT
AGATAACTCTGCGGTGTCGGCTAG -> GATAACTCTGCGGTGTCGGCTAGT
CGACCGTTATTGATACGTGGGACC -> GACCGTTATTGATACGTGGGACCG
GTGGGCTAGCACTATGTGTGTGGG -> TGGGCTAGCACTATGTGTGTGGGC
TTGGGATCTTGGCCAAGGAGCACA -> TGGGATCTTGGCCAAGGAGCACAG
GCTAGTACCAGAGGGTTTACTAGC -> CTAGTACCAGAGGGTTTACTAGCG
GGGGACATGATTCTCTATTGACCT -> GGGACATGATTCTCTATTGACCTA
CAGTATATGTCCTATCGGACCACT -> AGTATATGTCCTATCGGACCACTA
CCGCGTGAGGGCACAATGTCCGCT -> CGCGTGAGGGCACAATGTCCGCTA
CGCGTGAGGGCACAATGTCCGCTA -> GCGTGAGGGCACAATGTCCGCTAG
CGGCTGTGGTCACGGTCGGAAGAG -> GGCTGTGGTCACGGTCGGAAGAGA
CGCATTTATTCTCTCGACGGTACT -> GCATTTATTCTCTCGACGGTACTA
TACGGATGATGCTGAATCTAGTGC -> ACGGATGATGCTGAATCTAGTGCG
ATCCAACCACCCGGCGATTAGTCA -> TCCAACCACCCGGCGATTAGTCAC
CTGTAATAAGTGGACCTCATCCGT -> TGTAATAAGTGGACCTCATCCGTC
GCTGTAGGTCTTGAACATCGGAAG -> CTGTAGGTCTTGAACATCGGAAGA
ACATGTCTAGGGTGTTACCATTGG -> CATGTCTAGGGTGTTACCATTGGG
ACCTGTCTCTATGCCATATGGGAA -> CCTGTCTCTATGCCATATGGGAAA
TTCTAATCCGCGTGAGGGCACAAT -> TCTAATCCGCGTGAGGGCACAATG
CTTAGTATCTGTCTGGCCTGGGGG -> TTAGTATCTGTCTGGCCTGGGGGT
GATGACGAGTACTGAATCGTTGTC -> ATGACGAGTACTGAATCGTTGTCT
GCCGTAGTAACTTTCAAGAATGTT -> CCGTAGTAACTTTCAAGAATGTTC
AGTTGTGCTTAGGGGGACATGATT -> GTTGTGCTTAGGGGGACATGATTC
TCCAAGATAACTCTGCGGTGTCGG -> CCAAGATAACTCTGCGGTGTCGGC
CACAGATCGACTCAGAAGTAGTTT -> ACAGATCGACTCAGAAGTAGTTTA
GATTAGTCACTTCGCATTTATTCT -> ATTAGTCACTTCGCATTTATTCTC
ATCGGAAGAGACATCAACTTAGTA -> TCGGAAGAGACATCAACTTAGTAT
GATCTCAGTTTAGAACGTAGCCCC -> ATCTCAGTTTAGAACGTAGCCCCG
GGTCAAGCGATGCGGGGAAGTTAT -> GTCAAGCGATGCGGGGAAGTTATA
ATCAACTTAGTATCTGTCTGGCCT -> TCAACTTAGTATCTGTCTGGCCTG
GTCTTGAACATCGGAAGAGACATC -> TCTTGAACATCGGAAGAGACATCA
CTTCTATACTTTAACACGGCCTAC -> TTCTATACTTTAACACGGCCTACA
TAGTGCGCTCGGCCCCGGTATGTA -> AGTGCGCTCGGCCCCGGTATGTAA
ACTAACGTTGTTCTGTAGAGGGTC -> CTAACGTTGTTCTGTAGAGGGTCG
CCAAGGAGCACAGTATATGTCCTA -> CAAGGAGCACAGTATATGTCCTAT
TCGACTCAGAAGTAGTTTAATGCC -> CGACTCAGAAGTAGTTTAATGCCG
AGTGCGCTCGGCCCCGGTATGTAA -> GTGCGCTCGGCCCCGGTATGTAAT
AGACATCAACTTAGTATCTGTCTG -> GACATCAACTTAGTATCTGTCTGG
GTATGCGATGACGAGTACTGAATC -> TATGCGATGACGAGTACTGAATCG
GACTTGAAACACAGATCGACTCAG -> ACTTGAAACACAGATCGACTCAGA
CCGGAAGGTATAATTCGCTAGTAC -> CGGAAGGTATAATTCGCTAGTACC
TTCAGGTGCCCAACCAGGTATTAC -> TCAGGTGCCCAACCAGGTATTACA
CTCCGGAGGCGTTGGAGACGGTGC -> TCCGGAGGCGTTGGAGACGGTGCC
ATAACTCTGCGGTGTCGGCTAGTA -> TAACTCTGCGGTGTCGGCTAGTAT
GGAAGAGACATCAACTTAGTATCT -> GAAGAGACATCAACTTAGTATCTG
AATTTAATGGATTAGCGAAATGTT -> ATTTAATGGATTAGCGAAATGTTG
GTTTATCTGCTACTGCCGCCAAGA -> TTTATCTGCTACTGCCGCCAAGAT
GTATGGCAGAACGGGGAGTGATGT -> TATGGCAGAACGGGGAGTGATGTG
AGGGCACAATGTCCGCTAGCTTTA -> GGGCACAATGTCCGCTAGCTTTAA
TGGCCTGGGGGTCCACGGCTACCG -> GGCCTGGGGGTCCACGGCTACCGC
TAGGGTGTTACCATTGGGATCTTG -> AGGGTGTTACCATTGGGATCTTGG
GTAGTAACTTTCAAGAATGTTCGC -> TAGTAACTTTCAAGAATGTTCGCG
TTATTTCGGGTGGCGGCCAGGATA -> TATTTCGGGTGGCGGCCAGGATAG
TGAACATCGGAAGAGACATCAACT -> GAACATCGGAAGAGACATCAACTT
ACCTTTGAGCTAACTCAGGGGCGA -> CCTTTGAGCTAACTCAGGGGCGAA
GGTATGTAATCCGCAATAATCCTT -> GTATGTAATCCGCAATAATCCTTC
GGTATGCGATGACGAGTACTGAAT -> GTATGCGATGACGAGTACTGAATC
AGGGCATACACCACGGAGAACGCT -> GGGCATACACCACGGAGAACGCTG
CGGCTACCGCAAGAAAGAGAGAAC -> GGCTACCGCAAGAAAGAGAGAACA
ACTTGAAACACAGATCGACTCAGA -> CTTGAAACACAGATCGACTCAGAA
TAAGGATGCAGAGATACCACAATC -> AAGGATGCAGAGATACCACAATCA
CGGCCCTAGCGGAAGTCGATAGGT -> GGCCCTAGCGGAAGTCGATAGGTG
ACCTGAGTATGATGGGAGTAACCC -> CCTGAGTATGATGGGAGTAACCCT
TAAAGAGGGCATACACCACGGAGA -> AAAGAGGGCATACACCACGGAGAA
TCGGCTGTAGGTCTTGAACATCGG -> CGGCTGTAGGTCTTGAACATCGGA
GGTGGGCCAGCCTTTTAAGGTAAG -> GTGGGCCAGCCTTTTAAGGTAAGC
CTCAGGGGCGAACCACGCTGTCAA -> TCAGGGGCGAACCACGCTGTCAAA
AATGGACTAGCCTCTCTGATGAGG -> ATGGACTAGCCTCTCTGATGAGGC
TCGGTGGTGGGCCAGCCTTTTAAG -> CGGTGGTGGGCCAGCCTTTTAAGG
CACGTGCAGCGTGATGACAAGCGG -> ACGTGCAGCGTGATGACAAGCGGT
TATCCAACCACCCGGCGATTAGTC -> ATCCAACCACCCGGCGATTAGTCA
AGAAGTAGTTTAATGCCGATCGCG -> GAAGTAGTTTAATGCCGATCGCGT
TACCACCTGTCTCTATGCCATATG -> ACCACCTGTCTCTATGCCATATGG
TCCTCAAACAACTTGAGTTGTGCT -> CCTCAAACAACTTGAGTTGTGCTT
GCGTAGGATATTAAACTACACGGC -> CGTAGGATATTAAACTACACGGCT
TTTGCTTATACGCGGTAGCTGCTG -> TTGCTTATACGCGGTAGCTGCTGT
GGATTAGCGAAATGTTGATTGCGG -> GATTAGCGAAATGTTGATTGCGGG
CTCCTCAAACAACTTGAGTTGTGC -> TCCTCAAACAACTTGAGTTGTGCT
AGGGTGTTACCATTGGGATCTTGG -> GGGTGTTACCATTGGGATCTTGGC
TCCAACCACCCGGCGATTAGTCAC -> CCAACCACCCGGCGATTAGTCACT
GACGGTGCCATCGGGAAGCCACTC -> ACGGTGCCATCGGGAAGCCACTCA
CGTTAACTATGCGATAAGGTCCAT -> GTTAACTATGCGATAAGGTCCATA
AAAGAGGGCATACACCACGGAGAA -> AAGAGGGCATACACCACGGAGAAC
TTCATCTCCAAGTGGCTTAGCGCC -> TCATCTCCAAGTGGCTTAGCGCCA
TAATCCATGGGTGCATCTTCAATT -> AATCCATGGGTGCATCTTCAATTT
AGACCTGAGTATGATGGGAGTAAC -> GACCTGAGTATGATGGGAGTAACC
CACCGATCTTCGGCTTCATGCACA -> ACCGATCTTCGGCTTCATGCACAC
ACAATATGGTCCACAATCTAATAT -> CAATATGGTCCACAATCTAATATC
CTATGAGAGCATATCTTCTAATCC -> TATGAGAGCATATCTTCTAATCCG
ATATTAAACTACACGGCTGTGGTC -> TATTAAACTACACGGCTGTGGTCA
TTCCTATGAGAGCATATCTTCTAA -> TCCTATGAGAGCATATCTTCTAAT
TGACCTATGGTCAAACTTTAACGG -> GACCTATGGTCAAACTTTAACGGC
TATGAGAGCATATCTTCTAATCCG -> ATGAGAGCATATCTTCTAATCCGC
ATGATGGGAGTAACCCTTAGCAGT -> TGATGGGAGTAACCCTTAGCAGTA
TCTATACTTTAACACGGCCTACAC -> CTATACTTTAACACGGCCTACACG
CGGAAGAGACATCAACTTAGTATC -> GGAAGAGACATCAACTTAGTATCT
CCCCTAACACGTTAGGAGTGCGTC -> CCCTAACACGTTAGGAGTGCGTCT
CTAATATCCAACCACCCGGCGATT -> TAATATCCAACCACCCGGCGATTA
CCGCCAAGATTCCATCTTTTAACG -> CGCCAAGATTCCATCTTTTAACGC
CAATCTAATATCCAACCACCCGGC -> AATCTAATATCCAACCACCCGGCG
TACGTGGGACCGGGAGAGACCGGA -> ACGTGGGACCGGGAGAGACCGGAA
CTACAAGCGGTATGCGATGACGAG -> TACAAGCGGTATGCGATGACGAGT
TCGCATTTATTCTCTCGACGGTAC -> CGCATTTATTCTCTCGACGGTACT
CCACGGAGAACGCTGACTCTCCGA -> CACGGAGAACGCTGACTCTCCGAC
ACGGGGAGTGATGTGCATACTAAG -> CGGGGAGTGATGTGCATACTAAGC
ATACTAGTTCCTATGAGAGCATAT -> TACTAGTTCCTATGAGAGCATATC
TAACTCAGGGGCGAACCACGCTGT -> AACTCAGGGGCGAACCACGCTGTC
CGGTGTCGGCTAGTATCGATAAAG -> GGTGTCGGCTAGTATCGATAAAGT
AGTGGACCTCATCCGTCCAGACCT -> GTGGACCTCATCCGTCCAGACCTG
AAGTTATAATACCAGAGAAGCCGA -> AGTTATAATACCAGAGAAGCCGAG
GCCAATTATACCGTGGGCTAGCAC -> CCAATTATACCGTGGGCTAGCACT
ATTGCGGGAAGGTATTTGCTGCTA -> TTGCGGGAAGGTATTTGCTGCTAT
GCAGAACGGGGAGTGATGTGCATA -> CAGAACGGGGAGTGATGTGCATAC
AGGTATTACAGGGCTGAGTTTTCG -> GGTATTACAGGGCTGAGTTTTCGT
CAACCAGGCATGTTTATCTGCTAC -> AACCAGGCATGTTTATCTGCTACT
AGTTCCTATGAGAGCATATCTTCT -> GTTCCTATGAGAGCATATCTTCTA
CCAGGCATGTTTATCTGCTACTGC -> CAGGCATGTTTATCTGCTACTGCC
CCACCTGTCTCTATGCCATATGGG -> CACCTGTCTCTATGCCATATGGGA
AGCACAGTATATGTCCTATCGGAC -> GCACAGTATATGTCCTATCGGACC
GGAAGGTATTTGCTGCTATCGAGA -> GAAGGTATTTGCTGCTATCGAGAA
TGTAAATTGGTGCTACGCCACGGC -> GTAAATTGGTGCTACGCCACGGCG
GGTCTTGAACATCGGAAGAGACAT -> GTCTTGAACATCGGAAGAGACATC
CACGTGACTGGTGTAGGAGACTGA -> ACGTGACTGGTGTAGGAGACTGAA
TACGATCGCACATTTTGACGCTAA -> ACGATCGCACATTTTGACGCTAAA
GGTCGGAAGAGACATATTCAGGTG -> GTCGGAAGAGACATATTCAGGTGC
AGGGCTGAGTTTTCGTTCGCAATG -> GGGCTGAGTTTTCGTTCGCAATGG
TGACAAGCGGTTTGGCATTCTGCC -> GACAAGCGGTTTGGCATTCTGCCA
TCCGTTCAGCTTTGAGACTACAAG -> CCGTTCAGCTTTGAGACTACAAGC
CAGGATAGATTATAGAAGCACTGA -> AGGATAGATTATAGAAGCACTGAC
GTAGACGTGGTCTCGCCCCGGCCC -> TAGACGTGGTCTCGCCCCGGCCCT
GCACCGATCTTCGGCTTCATGCAC -> CACCGATCTTCGGCTTCATGCACA
CCAAGATAACTCTGCGGTGTCGGC -> CAAGATAACTCTGCGGTGTCGGCT
GTCGGAAGAGACATATTCAGGTGC -> TCGGAAGAGACATATTCAGGTGCC
AAGCGGTTTGGCATTCTGCCAGTT -> AGCGGTTTGGCATTCTGCCAGTTA
CCATGGGTGCATCTTCAATTTCCA -> CATGGGTGCATCTTCAATTTCCAA
GCACAATGTCCGCTAGCTTTAACA -> CACAATGTCCGCTAGCTTTAACAA
GGGAAGCCACTCAGATTGCGGGAA -> GGAAGCCACTCAGATTGCGGGAAG
TTGAGCTAACTCAGGGGCGAACCA -> TGAGCTAACTCAGGGGCGAACCAC
ACTCAGATTGCGGGAAGGTATTTG -> CTCAGATTGCGGGAAGGTATTTGC
TCCATGGGTGCATCTTCAATTTCC -> CCATGGGTGCATCTTCAATTTCCA
ATCTGTCTGGCCTGGGGGTCCACG -> TCTGTCTGGCCTGGGGGTCCACGG
TATGATGGGAGTAACCCTTAGCAG -> ATGATGGGAGTAACCCTTAGCAGT
CCCGGCGATTAGTCACTTCGCATT -> CCGGCGATTAGTCACTTCGCATTT
GGGTGCATCTTCAATTTCCAAGAT -> GGTGCATCTTCAATTTCCAAGATA
TGGGCCAGCCTTTTAAGGTAAGCT -> GGGCCAGCCTTTTAAGGTAAGCTA
AAGGCTTCTATACTTTAACACGGC -> AGGCTTCTATACTTTAACACGGCC
ACTAAGGATGCAGAGATACCACAA -> CTAAGGATGCAGAGATACCACAAT
AGATTCCATCTTTTAACGCAGCCG -> GATTCCATCTTTTAACGCAGCCGC
GGCGTGCCGTACGGATGATGCTGA -> GCGTGCCGTACGGATGATGCTGAA
TTGTCCGATTATCGGTTCCGTTCA -> TGTCCGATTATCGGTTCCGTTCAG
TCTTCAGCTCCGGAGGCGTTGGAG -> CTTCAGCTCCGGAGGCGTTGGAGA
TGACCAACACGCACGACTTGAAAC -> GACCAACACGCACGACTTGAAACA
GCAAGAAAGAGAGAACACGTGACT -> CAAGAAAGAGAGAACACGTGACTG
GCATGTTTATCTGCTACTGCCGCC -> CATGTTTATCTGCTACTGCCGCCA
GGTGATCTCAGTTTAGAACGTAGC -> GTGATCTCAGTTTAGAACGTAGCC
GCCGGAAGGTATAATTCGCTAGTA -> CCGGAAGGTATAATTCGCTAGTAC
CTCAAACAACTTGAGTTGTGCTTA -> TCAAACAACTTGAGTTGTGCTTAG
AGAGGGCATACACCACGGAGAACG -> GAGGGCATACACCACGGAGAACGC
TGCGATGACGAGTACTGAATCGTT -> GCGATGACGAGTACTGAATCGTTG
GCAATGGTAGTTGTCCGATTATCG -> CAATGGTAGTTGTCCGATTATCGG
ACGGTCGGAAGAGACATATTCAGG -> CGGTCGGAAGAGACATATTCAGGT
TTTCGTTCGCAATGGTAGTTGTCC -> TTCGTTCGCAATGGTAGTTGTCCG
TTGAGACTACAAGCGGTATGCGAT -> TGAGACTACAAGCGGTATGCGATG
ATGAGAGCATATCTTCTAATCCGC -> TGAGAGCATATCTTCTAATCCGCG
AACCCTTAGCAGTATAAGGCTTCT -> ACCCTTAGCAGTATAAGGCTTCTA
TAGTTCCTATGAGAGCATATCTTC -> AGTTCCTATGAGAGCATATCTTCT
ATCTGCTACTGCCGCCAAGATTCC -> TCTGCTACTGCCGCCAAGATTCCA
ATAAAGTATGGCAGAACGGGGAGT -> TAAAGTATGGCAGAACGGGGAGTG
CGGGAAGCCACTCAGATTGCGGGA -> GGGAAGCCACTCAGATTGCGGGAA
ATTTATTCTCTCGACGGTACTACA -> TTTATTCTCTCGACGGTACTACAA
TCTCGCCCCGGCCCTAGCGGAAGT -> CTCGCCCCGGCCCTAGCGGAAGTC
TGAGCTAACTCAGGGGCGAACCAC -> GAGCTAACTCAGGGGCGAACCACG
GTAACCCTTAGCAGTATAAGGCTT -> TAACCCTTAGCAGTATAAGGCTTC
CGATCTTCGGCTTCATGCACACTA -> GATCTTCGGCTTCATGCACACTAA
GCCATATGGGAAACGGCCTAATAC -> CCATATGGGAAACGGCCTAATACT
ATCCGTCCAGACCTGAGTATGATG -> TCCGTCCAGACCTGAGTATGATGG
TGGGAAACGGCCTAATACTAGTTC -> GGGAAACGGCCTAATACTAGTTCC
TCACTAACCTTTGAGCTAACTCAG -> CACTAACCTTTGAGCTAACTCAGG
AAGGTAAGCTACCAAAAATGTAAA -> AGGTAAGCTACCAAAAATGTAAAT
ATGACGAGTACTGAATCGTTGTCT -> TGACGAGTACTGAATCGTTGTCTC
GTCGATAGGTGAATATTTATTTCG -> TCGATAGGTGAATATTTATTTCGG
AGTACCAGAGGGTTTACTAGCGGC -> GTACCAGAGGGTTTACTAGCGGCG
GTGGGACCGGGAGAGACCGGAAAC -> TGGGACCGGGAGAGACCGGAAACA
AATTGGTGCTACGCCACGGCGAAT -> ATTGGTGCTACGCCACGGCGAATT
ATACTTTAACACGGCCTACACGGC -> TACTTTAACACGGCCTACACGGCA
GGGCGAACCACGCTGTCAAATTTA -> GGCGAACCACGCTGTCAAATTTAC
CTCGGTGGTGGGCCAGCCTTTTAA -> TCGGTGGTGGGCCAGCCTTTTAAG
CTAATACTAGTTCCTATGAGAGCA -> TAATACTAGTTCCTATGAGAGCAT
GGAAGGTATAATTCGCTAGTACCA -> GAAGGTATAATTCGCTAGTACCAG
CTAGGCCACCAACGCAACCAGGCA -> TAGGCCACCAACGCAACCAGGCAT
CATACGATCGCACATTTTGACGCT -> ATACGATCGCACATTTTGACGCTA
CTCAGAAGTAGTTTAATGCCGATC -> TCAGAAGTAGTTTAATGCCGATCG
CTAGCGGAAGTCGATAGGTGAATA -> TAGCGGAAGTCGATAGGTGAATAT
CCGGAAACATGTCTAGGGTGTTAC -> CGGAAACATGTCTAGGGTGTTACC
GCGGGGAAGTTATAATACCAGAGA -> CGGGGAAGTTATAATACCAGAGAA
CACTAGTGTCACTAACCTTTGAGC -> ACTAGTGTCACTAACCTTTGAGCT
TAACACGTTAGGAGTGCGTCTGGC -> AACACGTTAGGAGTGCGTCTGGCC
GGTATAATTCGCTAGTACCAGAGG -> GTATAATTCGCTAGTACCAGAGGG
TATGCGATGACGAGTACTGAATCG -> ATGCGATGACGAGTACTGAATCGT
TTATAGAAGCACTGACCAACACGC -> TATAGAAGCACTGACCAACACGCA
TGTCCGATTATCGGTTCCGTTCAG -> GTCCGATTATCGGTTCCGTTCAGC
CAGACCTGAGTATGATGGGAGTAA -> AGACCTGAGTATGATGGGAGTAAC
GTGCGCTCGGCCCCGGTATGTAAT -> TGCGCTCGGCCCCGGTATGTAATC
ATTGCGGGCCCAGCCTCGGTGGTG -> TTGCGGGCCCAGCCTCGGTGGTGG
GTTACCATTGGGATCTTGGCCAAG -> TTACCATTGGGATCTTGGCCAAGG
ACCACCCGGCGATTAGTCACTTCG -> CCACCCGGCGATTAGTCACTTCGC
GAGAAGCCGAGGGCTCACGGTCTA -> AGAAGCCGAGGGCTCACGGTCTAA
GGGGCGAACCACGCTGTCAAATTT -> GGGCGAACCACGCTGTCAAATTTA
AGGTGCCCAACCAGGTATTACAGG -> GGTGCCCAACCAGGTATTACAGGG
CCACTCAGATTGCGGGAAGGTATT -> CACTCAGATTGCGGGAAGGTATTT
GTGGCGGCCAGGATAGATTATAGA -> TGGCGGCCAGGATAGATTATAGAA
GAAGCCGAGGGCTCACGGTCTAAA -> AAGCCGAGGGCTCACGGTCTAAAT
AGTGATGTGCATACTAAGCACGTG -> GTGATGTGCATACTAAGCACGTGC
GTGTGTGGGCACGAACAATGAGTC -> TGTGTGGGCACGAACAATGAGTCA
AGCTACCAAAAATGTAAATTGGTG -> GCTACCAAAAATGTAAATTGGTGC
GTCACGGTCGGAAGAGACATATTC -> TCACGGTCGGAAGAGACATATTCA
TATTACAGGGCTGAGTTTTCGTTC -> ATTACAGGGCTGAGTTTTCGTTCG
TAGGCCACCAACGCAACCAGGCAT -> AGGCCACCAACGCAACCAGGCATG
TAGATTATAGAAGCACTGACCAAC -> AGATTATAGAAGCACTGACCAACA
CTAACGTTGTTCTGTAGAGGGTCG -> TAACGTTGTTCTGTAGAGGGTCGG
GTCACTAACCTTTGAGCTAACTCA -> TCACTAACCTTTGAGCTAACTCAG
AAATGTTGATTGCGGGCCCAGCCT -> AATGTTGATTGCGGGCCCAGCCTC
CTGCTGTAATAAGTGGACCTCATC -> TGCTGTAATAAGTGGACCTCATCC
CGGTAGCTGCTGTAGACGTGGTCT -> GGTAGCTGCTGTAGACGTGGTCTC
TCAAACAACTTGAGTTGTGCTTAG -> CAAACAACTTGAGTTGTGCTTAGG
GAGGGTCGGCCAATTATACCGTGG -> AGGGTCGGCCAATTATACCGTGGG
CTTCGGCTTCATGCACACTAACGT -> TTCGGCTTCATGCACACTAACGTT
TTTAACACGGCCTACACGGCAAGA -> TTAACACGGCCTACACGGCAAGAT
GGGACATGATTCTCTATTGACCTA -> GGACATGATTCTCTATTGACCTAT
ACGCCGTAGTAACTTTCAAGAATG -> CGCCGTAGTAACTTTCAAGAATGT
ACGGATGATGCTGAATCTAGTGCG -> CGGATGATGCTGAATCTAGTGCGC
GCCCTAGCGGAAGTCGATAGGTGA -> CCCTAGCGGAAGTCGATAGGTGAA
GACTAGCCTCTCTGATGAGGCGAT -> ACTAGCCTCTCTGATGAGGCGATT
GCTGTAGACGTGGTCTCGCCCCGG -> CTGTAGACGTGGTCTCGCCCCGGC
GCCGTACGGATGATGCTGAATCTA -> CCGTACGGATGATGCTGAATCTAG
ATCGACTCAGAAGTAGTTTAATGC -> TCGACTCAGAAGTAGTTTAATGCC
GGGTCCACGGCTACCGCAAGAAAG -> GGTCCACGGCTACCGCAAGAAAGA
CTAGCACTATGTGTGTGGGCACGA -> TAGCACTATGTGTGTGGGCACGAA
TCTCAGTTTAGAACGTAGCCCCGC -> CTCAGTTTAGAACGTAGCCCCGCT
TGTCTGCTGTAATAAGTGGACCTC -> GTCTGCTGTAATAAGTGGACCTCA
GTATGATGGGAGTAACCCTTAGCA -> TATGATGGGAGTAACCCTTAGCAG
GCTTTCATCTCCAAGTGGCTTAGC -> CTTTCATCTCCAAGTGGCTTAGCG
GGTGTTACCATTGGGATCTTGGCC -> GTGTTACCATTGGGATCTTGGCCA
GCATGCTGCTTTCATCTCCAAGTG -> CATGCTGCTTTCATCTCCAAGTGG
TGATGCTGAATCTAGTGCGCTCGG -> GATGCTGAATCTAGTGCGCTCGGC
GCACAGTATATGTCCTATCGGACC -> CACAGTATATGTCCTATCGGACCA
GTGATGTGCATACTAAGCACGTGC -> TGATGTGCATACTAAGCACGTGCA
TTCGGCTTCATGCACACTAACGTT -> TCGGCTTCATGCACACTAACGTTG
TCTGCTACTGCCGCCAAGATTCCA -> CTGCTACTGCCGCCAAGATTCCAT
GGAGAGACCGGAAACATGTCTAGG -> GAGAGACCGGAAACATGTCTAGGG
GAGTAACCCTTAGCAGTATAAGGC -> AGTAACCCTTAGCAGTATAAGGCT
TCATCTCCAAGTGGCTTAGCGCCA -> CATCTCCAAGTGGCTTAGCGCCAA
CTTAGACGCCGTAGTAACTTTCAA -> TTAGACGCCGTAGTAACTTTCAAG
GATACGTGGGACCGGGAGAGACCG -> ATACGTGGGACCGGGAGAGACCGG
TCGCCCCGGCCCTAGCGGAAGTCG -> CGCCCCGGCCCTAGCGGAAGTCGA
ACTACAAGGTGCCCCTAACACGTT -> CTACAAGGTGCCCCTAACACGTTA
TTAATGGATTAGCGAAATGTTGAT -> TAATGGATTAGCGAAATGTTGATT
ATGGTAGTTGTCCGATTATCGGTT -> TGGTAGTTGTCCGATTATCGGTTC
GGGAGAGACCGGAAACATGTCTAG -> GGAGAGACCGGAAACATGTCTAGG
AACGGCCTAATACTAGTTCCTATG -> ACGGCCTAATACTAGTTCCTATGA
CGATTATCGGTTCCGTTCAGCTTT -> GATTATCGGTTCCGTTCAGCTTTG
GAGACGGTGCCATCGGGAAGCCAC -> AGACGGTGCCATCGGGAAGCCACT
CTCTCGACGGTACTACAAGGTGCC -> TCTCGACGGTACTACAAGGTGCCC
GCCTTTTAAGGTAAGCTACCAAAA -> CCTTTTAAGGTAAGCTACCAAAAA
CAGAAGTAGTTTAATGCCGATCGC -> AGAAGTAGTTTAATGCCGATCGCG
CTTTTAAGGTAAGCTACCAAAAAT -> TTTTAAGGTAAGCTACCAAAAATG
CCATCGGGAAGCCACTCAGATTGC -> CATCGGGAAGCCACTCAGATTGCG
ACATCAACTTAGTATCTGTCTGGC -> CATCAACTTAGTATCTGTCTGGCC
TTAGGGGGACATGATTCTCTATTG -> TAGGGGGACATGATTCTCTATTGA
GTGCCCCTAACACGTTAGGAGTGC -> TGCCCCTAACACGTTAGGAGTGCG
TAGTTTAATGCCGATCGCGTAGGA -> AGTTTAATGCCGATCGCGTAGGAT
CACGGCTGTGGTCACGGTCGGAAG -> ACGGCTGTGGTCACGGTCGGAAGA
TAGCGGCGTGCCGTACGGATGATG -> AGCGGCGTGCCGTACGGATGATGC
CGATGACGAGTACTGAATCGTTGT -> GATGACGAGTACTGAATCGTTGTC
CACGGCGAATTTGGTGATCTCAGT -> ACGGCGAATTTGGTGATCTCAGTT
TGTGCTTAGGGGGACATGATTCTC -> GTGCTTAGGGGGACATGATTCTCT
TATGGGAAACGGCCTAATACTAGT -> ATGGGAAACGGCCTAATACTAGTT
GCCATGATGCCGGAAGGTATAATT -> CCATGATGCCGGAAGGTATAATTC
ACACGTGACTGGTGTAGGAGACTG -> CACGTGACTGGTGTAGGAGACTGA
TAGCGAAATGTTGATTGCGGGCCC -> AGCGAAATGTTGATTGCGGGCCCA
GAACATCGGAAGAGACATCAACTT -> AACATCGGAAGAGACATCAACTTA
TGCTTATACGCGGTAGCTGCTGTA -> GCTTATACGCGGTAGCTGCTGTAG
ACACGGCAAGATCTTCAGCTCCGG -> CACGGCAAGATCTTCAGCTCCGGA
ATTTCCAAGATAACTCTGCGGTGT -> TTTCCAAGATAACTCTGCGGTGTC
TGGCCAAGGAGCACAGTATATGTC -> GGCCAAGGAGCACAGTATATGTCC
GAACACGTGACTGGTGTAGGAGAC -> AACACGTGACTGGTGTAGGAGACT
TGAGTATGATGGGAGTAACCCTTA -> GAGTATGATGGGAGTAACCCTTAG
GCCAATAAATGGACTAGCCTCTCT -> CCAATAAATGGACTAGCCTCTCTG
ACCACCTGTCTCTATGCCATATGG -> CCACCTGTCTCTATGCCATATGGG
ACGGCAAGATCTTCAGCTCCGGAG -> CGGCAAGATCTTCAGCTCCGGAGG
ACCCTTAGCAGTATAAGGCTTCTA -> CCCTTAGCAGTATAAGGCTTCTAT
CAATACCGGTGGGAAAGCACCGAT -> AATACCGGTGGGAAAGCACCGATC
GAGACTGAATTTAATGGATTAGCG -> AGACTGAATTTAATGGATTAGCGA
TATGTAATCCGCAATAATCCTTCT -> ATGTAATCCGCAATAATCCTTCTA
AAACAACTTGAGTTGTGCTTAGGG -> AACAACTTGAGTTGTGCTTAGGGG
TCTAGTGCGCTCGGCCCCGGTATG -> CTAGTGCGCTCGGCCCCGGTATGT
GGCAGCTGTCTGCTGTAATAAGTG -> GCAGCTGTCTGCTGTAATAAGTGG
CGCCAATGTATTAGGCGGTCAAGC -> GCCAATGTATTAGGCGGTCAAGCG
GGCCATGATGCCGGAAGGTATAAT -> GCCATGATGCCGGAAGGTATAATT
CTCCGACGTCCTCGGCTGTAGGTC -> TCCGACGTCCTCGGCTGTAGGTCT
AGGGTTTACTAGCGGCGTGCCGTA -> GGGTTTACTAGCGGCGTGCCGTAC
TGGAGACGGTGCCATCGGGAAGCC -> GGAGACGGTGCCATCGGGAAGCCA
AGAACGGGGAGTGATGTGCATACT -> GAACGGGGAGTGATGTGCATACTA
ATGCACACTAACGTTGTTCTGTAG -> TGCACACTAACGTTGTTCTGTAGA
CTGACTCTCCGACGTCCTCGGCTG -> TGACTCTCCGACGTCCTCGGCTGT
CCTAATACTAGTTCCTATGAGAGC -> CTAATACTAGTTCCTATGAGAGCA
TAACGCAGCCGCCGTTAACTATGC -> AACGCAGCCGCCGTTAACTATGCG
TAGGGGGACATGATTCTCTATTGA -> AGGGGGACATGATTCTCTATTGAC
ACCGTTATTGATACGTGGGACCGG -> CCGTTATTGATACGTGGGACCGGG
TAATCCGCAATAATCCTTCTAGGC -> AATCCGCAATAATCCTTCTAGGCC
ACTCTGCGGTGTCGGCTAGTATCG -> CTCTGCGGTGTCGGCTAGTATCGA
AATTCGCTAGTACCAGAGGGTTTA -> ATTCGCTAGTACCAGAGGGTTTAC
CGGCCATGATGCCGGAAGGTATAA -> GGCCATGATGCCGGAAGGTATAAT
CACCACGGAGAACGCTGACTCTCC -> ACCACGGAGAACGCTGACTCTCCG
AATTGGTTTTCTACCACCTGTCTC -> ATTGGTTTTCTACCACCTGTCTCT
TCTACCACCTGTCTCTATGCCATA -> CTACCACCTGTCTCTATGCCATAT
CGTAGGATATTAAACTACACGGCT -> GTAGGATATTAAACTACACGGCTG
GTGGGAAAGCACCGATCTTCGGCT -> TGGGAAAGCACCGATCTTCGGCTT
TAACAATATGGTCCACAATCTAAT -> AACAATATGGTCCACAATCTAATA
GTCCTATCGGACCACTAGTGTCAC -> TCCTATCGGACCACTAGTGTCACT
CGTAGCCCCGCTTAGACGCCGTAG -> GTAGCCCCGCTTAGACGCCGTAGT
CAGCCTTTTAAGGTAAGCTACCAA -> AGCCTTTTAAGGTAAGCTACCAAA
CGGGGAGTGATGTGCATACTAAGC -> GGGGAGTGATGTGCATACTAAGCA
TATGTGTGTGGGCACGAACAATGA -> ATGTGTGTGGGCACGAACAATGAG
GCTGCTGTAGACGTGGTCTCGCCC -> CTGCTGTAGACGTGGTCTCGCCCC
CAATTATACCGTGGGCTAGCACTA -> AATTATACCGTGGGCTAGCACTAT
CAGGTGCCCAACCAGGTATTACAG -> AGGTGCCCAACCAGGTATTACAGG
TATTTATTTCGGGTGGCGGCCAGG -> ATTTATTTCGGGTGGCGGCCAGGA
GGTTTTGCTTATACGCGGTAGCTG -> GTTTTGCTTATACGCGGTAGCTGC
GGCATGTTTATCTGCTACTGCCGC -> GCATGTTTATCTGCTACTGCCGCC
CCGGTGGGAAAGCACCGATCTTCG -> CGGTGGGAAAGCACCGATCTTCGG
CCCTAACACGTTAGGAGTGCGTCT -> CCTAACACGTTAGGAGTGCGTCTG
CGGCCCCGGTATGTAATCCGCAAT -> GGCCCCGGTATGTAATCCGCAATA
CGAACCACGCTGTCAAATTTACGC -> GAACCACGCTGTCAAATTTACGCA
ACCAGAGAAGCCGAGGGCTCACGG -> CCAGAGAAGCCGAGGGCTCACGGT
TATTGATACGTGGGACCGGGAGAG -> ATTGATACGTGGGACCGGGAGAGA
TCCGTCCAGACCTGAGTATGATGG -> CCGTCCAGACCTGAGTATGATGGG
TTCTGTAGAGGGTCGGCCAATTAT -> TCTGTAGAGGGTCGGCCAATTATA
GGGCCAGCCTTTTAAGGTAAGCTA -> GGCCAGCCTTTTAAGGTAAGCTAC
CTCTCTGATGAGGCGATTTTGTCA -> TCTCTGATGAGGCGATTTTGTCAG
TAATAAGTGGACCTCATCCGTCCA -> AATAAGTGGACCTCATCCGTCCAG
CCTGAGTATGATGGGAGTAACCCT -> CTGAGTATGATGGGAGTAACCCTT
CGATCGCGTAGGATATTAAACTAC -> GATCGCGTAGGATATTAAACTACA
ATTCAGGTGCCCAACCAGGTATTA -> TTCAGGTGCCCAACCAGGTATTAC
ATTTTGTCAGACAGACAATACCGG -> TTTTGTCAGACAGACAATACCGGT
ACCGGAAACATGTCTAGGGTGTTA -> CCGGAAACATGTCTAGGGTGTTAC
ATTGGGATCTTGGCCAAGGAGCAC -> TTGGGATCTTGGCCAAGGAGCACA
GGCTCACGGTCTAAATCCAGGCGG -> GCTCACGGTCTAAATCCAGGCGGC
TGCTTTCATCTCCAAGTGGCTTAG -> GCTTTCATCTCCAAGTGGCTTAGC
GTCACTTCGCATTTATTCTCTCGA -> TCACTTCGCATTTATTCTCTCGAC
GGGTTTACTAGCGGCGTGCCGTAC -> GGTTTACTAGCGGCGTGCCGTACG
GATTTTGTCAGACAGACAATACCG -> ATTTTGTCAGACAGACAATACCGG
CTATGCGATAAGGTCCATACGATC -> TATGCGATAAGGTCCATACGATCG
ACACGCACGACTTGAAACACAGAT -> CACGCACGACTTGAAACACAGATC
ACTAACCTTTGAGCTAACTCAGGG -> CTAACCTTTGAGCTAACTCAGGGG
TAATATCCAACCACCCGGCGATTA -> AATATCCAACCACCCGGCGATTAG
TTTTAACGCAGCCGCCGTTAACTA -> TTTAACGCAGCCGCCGTTAACTAT
CTTAGCGCCAATGTATTAGGCGGT -> TTAGCGCCAATGTATTAGGCGGTC
ATGTCCTATCGGACCACTAGTGTC -> TGTCCTATCGGACCACTAGTGTCA
ATGAGGCGATTTTGTCAGACAGAC -> TGAGGCGATTTTGTCAGACAGACA
GCCACTCAGATTGCGGGAAGGTAT -> CCACTCAGATTGCGGGAAGGTATT
ATGGTCCACAATCTAATATCCAAC -> TGGTCCACAATCTAATATCCAACC
GGGCTAGCACTATGTGTGTGGGCA -> GGCTAGCACTATGTGTGTGGGCAC
GAGTGCGTCTGGCCAATAAATGGA -> AGTGCGTCTGGCCAATAAATGGAC
TGTAGGTCTTGAACATCGGAAGAG -> GTAGGTCTTGAACATCGGAAGAGA
CCTCAAACAACTTGAGTTGTGCTT -> CTCAAACAACTTGAGTTGTGCTTA
ACAATGAGTCAAGAGGTTTTGCTT -> CAATGAGTCAAGAGGTTTTGCTTA
GTCTGGCCTGGGGGTCCACGGCTA -> TCTGGCCTGGGGGTCCACGGCTAC
AGCCGAGGGCTCACGGTCTAAATC -> GCCGAGGGCTCACGGTCTAAATCC
ATTTTGACGCTAAAGAGGGCATAC -> TTTTGACGCTAAAGAGGGCATACA
TTATCGGTTCCGTTCAGCTTTGAG -> TATCGGTTCCGTTCAGCTTTGAGA
GTCGGCTAGTATCGATAAAGTATG -> TCGGCTAGTATCGATAAAGTATGG
TCAGTTTAGAACGTAGCCCCGCTT -> CAGTTTAGAACGTAGCCCCGCTTA
ACGGTACTACAAGGTGCCCCTAAC -> CGGTACTACAAGGTGCCCCTAACA
AACCACGCTGTCAAATTTACGCAG -> ACCACGCTGTCAAATTTACGCAGT
CAGGGGCGAACCACGCTGTCAAAT -> AGGGGCGAACCACGCTGTCAAATT
GATGTGCATACTAAGCACGTGCAG -> ATGTGCATACTAAGCACGTGCAGC
TACTGAATCGTTGTCTCCTCAAAC -> ACTGAATCGTTGTCTCCTCAAACA
CACTAACGTTGTTCTGTAGAGGGT -> ACTAACGTTGTTCTGTAGAGGGTC
TGCTACTGCCGCCAAGATTCCATC -> GCTACTGCCGCCAAGATTCCATCT
ATGATGCTGAATCTAGTGCGCTCG -> TGATGCTGAATCTAGTGCGCTCGG
CCCCGCTTAGACGCCGTAGTAACT -> CCCGCTTAGACGCCGTAGTAACTT
ACGAGTACTGAATCGTTGTCTCCT -> CGAGTACTGAATCGTTGTCTCCTC
CTGAATCGTTGTCTCCTCAAACAA -> TGAATCGTTGTCTCCTCAAACAAC
ACATATTCAGGTGCCCAACCAGGT -> CATATTCAGGTGCCCAACCAGGTA
ACCAGGCATGTTTATCTGCTACTG -> CCAGGCATGTTTATCTGCTACTGC
GTCCATACGATCGCACATTTTGAC -> TCCATACGATCGCACATTTTGACG
GTGGGCCAGCCTTTTAAGGTAAGC -> TGGGCCAGCCTTTTAAGGTAAGCT
TCCTATCGGACCACTAGTGTCACT -> CCTATCGGACCACTAGTGTCACTA
GATAAGGTCCATACGATCGCACAT -> ATAAGGTCCATACGATCGCACATT
CTGCCGCCAAGATTCCATCTTTTA -> TGCCGCCAAGATTCCATCTTTTAA
GTGATGACAAGCGGTTTGGCATTC -> TGATGACAAGCGGTTTGGCATTCT
GCCGATCGCGTAGGATATTAAACT -> CCGATCGCGTAGGATATTAAACTA
GAAAGAGAGAACACGTGACTGGTG -> AAAGAGAGAACACGTGACTGGTGT
CCATGATGCCGGAAGGTATAATTC -> CATGATGCCGGAAGGTATAATTCG
ACGGCGAATTTGGTGATCTCAGTT -> CGGCGAATTTGGTGATCTCAGTTT
GAAATGTTGATTGCGGGCCCAGCC -> AAATGTTGATTGCGGGCCCAGCCT
CGCCCCGGCCCTAGCGGAAGTCGA -> GCCCCGGCCCTAGCGGAAGTCGAT
AAAGAGAGAACACGTGACTGGTGT -> AAGAGAGAACACGTGACTGGTGTA
GGCTTAGCGCCAATGTATTAGGCG -> GCTTAGCGCCAATGTATTAGGCGG
AAAGCACCGATCTTCGGCTTCATG -> AAGCACCGATCTTCGGCTTCATGC
CGTGCCGTACGGATGATGCTGAAT -> GTGCCGTACGGATGATGCTGAATC
TACCGTGGGCTAGCACTATGTGTG -> ACCGTGGGCTAGCACTATGTGTGT
GCTACCAAAAATGTAAATTGGTGC -> CTACCAAAAATGTAAATTGGTGCT
AGAAGCCGAGGGCTCACGGTCTAA -> GAAGCCGAGGGCTCACGGTCTAAA
TTTGAGACTACAAGCGGTATGCGA -> TTGAGACTACAAGCGGTATGCGAT
TAAATCCAGGCGGCAGCTGTCTGC -> AAATCCAGGCGGCAGCTGTCTGCT
TGCTGCTATCGAGAAAGGAGCGTA -> GCTGCTATCGAGAAAGGAGCGTAA
CTAGCCTCTCTGATGAGGCGATTT -> TAGCCTCTCTGATGAGGCGATTTT
TCGATAAAGTATGGCAGAACGGGG -> CGATAAAGTATGGCAGAACGGGGA
ATAAATGGACTAGCCTCTCTGATG -> TAAATGGACTAGCCTCTCTGATGA
TAACTATGCGATAAGGTCCATACG -> AACTATGCGATAAGGTCCATACGA
TATGTCCTATCGGACCACTAGTGT -> ATGTCCTATCGGACCACTAGTGTC
CCCCGGTATGTAATCCGCAATAAT -> CCCGGTATGTAATCCGCAATAATC
GCGATTTTGTCAGACAGACAATAC -> CGATTTTGTCAGACAGACAATACC
GAGGCGATTTTGTCAGACAGACAA -> AGGCGATTTTGTCAGACAGACAAT
ACGTTGTTCTGTAGAGGGTCGGCC -> CGTTGTTCTGTAGAGGGTCGGCCA
CAAGAATGTTCGCGACCGTTATTG -> AAGAATGTTCGCGACCGTTATTGA
AGCCTCTCTGATGAGGCGATTTTG -> GCCTCTCTGATGAGGCGATTTTGT
AGAACGTAGCCCCGCTTAGACGCC -> GAACGTAGCCCCGCTTAGACGCCG
GGCCTGGGGGTCCACGGCTACCGC -> GCCTGGGGGTCCACGGCTACCGCA
AGAGACATCAACTTAGTATCTGTC -> GAGACATCAACTTAGTATCTGTCT
AGAATGTTCGCGACCGTTATTGAT -> GAATGTTCGCGACCGTTATTGATA
GACAATACCGGTGGGAAAGCACCG -> ACAATACCGGTGGGAAAGCACCGA
CCGGCGATTAGTCACTTCGCATTT -> CGGCGATTAGTCACTTCGCATTTA
TTTATTCTCTCGACGGTACTACAA -> TTATTCTCTCGACGGTACTACAAG
AAGGATGCAGAGATACCACAATCA -> AGGATGCAGAGATACCACAATCAA
GCTGTAATAAGTGGACCTCATCCG -> CTGTAATAAGTGGACCTCATCCGT
TCTCGACGGTACTACAAGGTGCCC -> CTCGACGGTACTACAAGGTGCCCC
GAATATTTATTTCGGGTGGCGGCC -> AATATTTATTTCGGGTGGCGGCCA
TAGCCTCTCTGATGAGGCGATTTT -> AGCCTCTCTGATGAGGCGATTTTG
TTCTCTCGACGGTACTACAAGGTG -> TCTCTCGACGGTACTACAAGGTGC
CAACACGCACGACTTGAAACACAG -> AACACGCACGACTTGAAACACAGA
TGAGGGCACAATGTCCGCTAGCTT -> GAGGGCACAATGTCCGCTAGCTTT
GTATTTGCTGCTATCGAGAAAGGA -> TATTTGCTGCTATCGAGAAAGGAG
CATTCTGCCAGTTAAATACTCGGC -> ATTCTGCCAGTTAAATACTCGGCC
TTTTGCTTATACGCGGTAGCTGCT -> TTTGCTTATACGCGGTAGCTGCTG
CCCAACCAGGTATTACAGGGCTGA -> CCAACCAGGTATTACAGGGCTGAG
CTAGGGTGTTACCATTGGGATCTT -> TAGGGTGTTACCATTGGGATCTTG
GTCTCCTCAAACAACTTGAGTTGT -> TCTCCTCAAACAACTTGAGTTGTG
GCGGGAAGGTATTTGCTGCTATCG -> CGGGAAGGTATTTGCTGCTATCGA
AAAGGAGCGTAATCCATGGGTGCA -> AAGGAGCGTAATCCATGGGTGCAT
ATTAGTCACTTCGCATTTATTCTC -> TTAGTCACTTCGCATTTATTCTCT
TACTAGTTCCTATGAGAGCATATC -> ACTAGTTCCTATGAGAGCATATCT
GAGGCGTTGGAGACGGTGCCATCG -> AGGCGTTGGAGACGGTGCCATCGG
TAGCGCCAATGTATTAGGCGGTCA -> AGCGCCAATGTATTAGGCGGTCAA
CTTTCATCTCCAAGTGGCTTAGCG -> TTTCATCTCCAAGTGGCTTAGCGC
CGCTAGTACCAGAGGGTTTACTAG -> GCTAGTACCAGAGGGTTTACTAGC
TCAATTGGTTTTCTACCACCTGTC -> CAATTGGTTTTCTACCACCTGTCT
TGTATTAGGCGGTCAAGCGATGCG -> GTATTAGGCGGTCAAGCGATGCGG
GTAGAGGGTCGGCCAATTATACCG -> TAGAGGGTCGGCCAATTATACCGT
GTAGGAGACTGAATTTAATGGATT -> TAGGAGACTGAATTTAATGGATTA
TATCGAGAAAGGAGCGTAATCCAT -> ATCGAGAAAGGAGCGTAATCCATG
CTCCAAGTGGCTTAGCGCCAATGT -> TCCAAGTGGCTTAGCGCCAATGTA
GAGGGCATACACCACGGAGAACGC -> AGGGCATACACCACGGAGAACGCT
GACATATTCAGGTGCCCAACCAGG -> ACATATTCAGGTGCCCAACCAGGT
CACAATGTCCGCTAGCTTTAACAA -> ACAATGTCCGCTAGCTTTAACAAT
GGACCACTAGTGTCACTAACCTTT -> GACCACTAGTGTCACTAACCTTTG
TCTATGCCATATGGGAAACGGCCT -> CTATGCCATATGGGAAACGGCCTA
ATACTAAGCACGTGCAGCGTGATG -> TACTAAGCACGTGCAGCGTGATGA
CGGACCACTAGTGTCACTAACCTT -> GGACCACTAGTGTCACTAACCTTT
GAGGGCACAATGTCCGCTAGCTTT -> AGGGCACAATGTCCGCTAGCTTTA
GCTAGCACTATGTGTGTGGGCACG -> CTAGCACTATGTGTGTGGGCACGA
GTAATCCATGGGTGCATCTTCAAT -> TAATCCATGGGTGCATCTTCAATT
CAATGTCCGCTAGCTTTAACAATA -> AATGTCCGCTAGCTTTAACAATAT
CTAATCCGCGTGAGGGCACAATGT -> TAATCCGCGTGAGGGCACAATGTC
AGGAGCGTAATCCATGGGTGCATC -> GGAGCGTAATCCATGGGTGCATCT
ATCCGCGTGAGGGCACAATGTCCG -> TCCGCGTGAGGGCACAATGTCCGC
AGTCGATAGGTGAATATTTATTTC -> GTCGATAGGTGAATATTTATTTCG
GGTTCCGTTCAGCTTTGAGACTAC -> GTTCCGTTCAGCTTTGAGACTACA
ACTTGAGTTGTGCTTAGGGGGACA -> CTTGAGTTGTGCTTAGGGGGACAT
TGCCGCCAAGATTCCATCTTTTAA -> GCCGCCAAGATTCCATCTTTTAAC
TGCCGTACGGATGATGCTGAATCT -> GCCGTACGGATGATGCTGAATCTA
GCGGTGTCGGCTAGTATCGATAAA -> CGGTGTCGGCTAGTATCGATAAAG
GGAAGAGACATATTCAGGTGCCCA -> GAAGAGACATATTCAGGTGCCCAA
AAGGTATTTGCTGCTATCGAGAAA -> AGGTATTTGCTGCTATCGAGAAAG
CTCTATTGACCTATGGTCAAACTT -> TCTATTGACCTATGGTCAAACTTT
CATATCTTCTAATCCGCGTGAGGG -> ATATCTTCTAATCCGCGTGAGGGC
GTAGCCCCGCTTAGACGCCGTAGT -> TAGCCCCGCTTAGACGCCGTAGTA
GGCTTCTATACTTTAACACGGCCT -> GCTTCTATACTTTAACACGGCCTA
AATCTAGTGCGCTCGGCCCCGGTA -> ATCTAGTGCGCTCGGCCCCGGTAT
TTGTGCTTAGGGGGACATGATTCT -> TGTGCTTAGGGGGACATGATTCTC
CGCAGCCGCCGTTAACTATGCGAT -> GCAGCCGCCGTTAACTATGCGATA
TTGTCTCCTCAAACAACTTGAGTT -> TGTCTCCTCAAACAACTTGAGTTG
TTAATGCCGATCGCGTAGGATATT -> TAATGCCGATCGCGTAGGATATTA
ACCACGGAGAACGCTGACTCTCCG -> CCACGGAGAACGCTGACTCTCCGA
AATCGTTGTCTCCTCAAACAACTT -> ATCGTTGTCTCCTCAAACAACTTG
AATGTCCGCTAGCTTTAACAATAT -> ATGTCCGCTAGCTTTAACAATATG
TGTGGTCACGGTCGGAAGAGACAT -> GTGGTCACGGTCGGAAGAGACATA
TCGATAGGTGAATATTTATTTCGG -> CGATAGGTGAATATTTATTTCGGG
CTTTGAGCTAACTCAGGGGCGAAC -> TTTGAGCTAACTCAGGGGCGAACC
TACTTTAACACGGCCTACACGGCA -> ACTTTAACACGGCCTACACGGCAA
TTATTGATACGTGGGACCGGGAGA -> TATTGATACGTGGGACCGGGAGAG
GGCGTTGGAGACGGTGCCATCGGG -> GCGTTGGAGACGGTGCCATCGGGA
GCTACGCCACGGCGAATTTGGTGA -> CTACGCCACGGCGAATTTGGTGAT
TGCCAGTTAAATACTCGGCCATGA -> GCCAGTTAAATACTCGGCCATGAT
GGCTACCGCAAGAAAGAGAGAACA -> GCTACCGCAAGAAAGAGAGAACAC
GAACGCTGACTCTCCGACGTCCTC -> AACGCTGACTCTCCGACGTCCTCG
CCTATGAGAGCATATCTTCTAATC -> CTATGAGAGCATATCTTCTAATCC
TGGTGTAGGAGACTGAATTTAATG -> GGTGTAGGAGACTGAATTTAATGG
AACTATGCGATAAGGTCCATACGA -> ACTATGCGATAAGGTCCATACGAT
TAGGCGGTCAAGCGATGCGGGGAA -> AGGCGGTCAAGCGATGCGGGGAAG
AAGGAGCGTAATCCATGGGTGCAT -> AGGAGCGTAATCCATGGGTGCATC
GAGACCGGAAACATGTCTAGGGTG -> AGACCGGAAACATGTCTAGGGTGT
CGGTGGGAAAGCACCGATCTTCGG -> GGTGGGAAAGCACCGATCTTCGGC
ACAAGGTGCCCCTAACACGTTAGG -> CAAGGTGCCCCTAACACGTTAGGA
CAGAACGGGGAGTGATGTGCATAC -> AGAACGGGGAGTGATGTGCATACT
TCAGATTGCGGGAAGGTATTTGCT -> CAGATTGCGGGAAGGTATTTGCTG
GCACATTTTGACGCTAAAGAGGGC -> CACATTTTGACGCTAAAGAGGGCA
GTGCTTAGGGGGACATGATTCTCT -> TGCTTAGGGGGACATGATTCTCTA
AGCTGTCTGCTGTAATAAGTGGAC -> GCTGTCTGCTGTAATAAGTGGACC
TACACGGCTGTGGTCACGGTCGGA -> ACACGGCTGTGGTCACGGTCGGAA
ATTGATACGTGGGACCGGGAGAGA -> TTGATACGTGGGACCGGGAGAGAC
CGACGTCCTCGGCTGTAGGTCTTG -> GACGTCCTCGGCTGTAGGTCTTGA
TCAAGCGATGCGGGGAAGTTATAA -> CAAGCGATGCGGGGAAGTTATAAT
TCCTCGGCTGTAGGTCTTGAACAT -> CCTCGGCTGTAGGTCTTGAACATC
AACGTTGTTCTGTAGAGGGTCGGC -> ACGTTGTTCTGTAGAGGGTCGGCC
GGCTAGCACTATGTGTGTGGGCAC -> GCTAGCACTATGTGTGTGGGCACG
AAGATAACTCTGCGGTGTCGGCTA -> AGATAACTCTGCGGTGTCGGCTAG
TCGGGAAGCCACTCAGATTGCGGG -> CGGGAAGCCACTCAGATTGCGGGA
AGTAGTTTAATGCCGATCGCGTAG -> GTAGTTTAATGCCGATCGCGTAGG
CTCTCCGACGTCCTCGGCTGTAGG -> TCTCCGACGTCCTCGGCTGTAGGT
ACTCAGAAGTAGTTTAATGCCGAT -> CTCAGAAGTAGTTTAATGCCGATC
GCTTATACGCGGTAGCTGCTGTAG -> CTTATACGCGGTAGCTGCTGTAGA
CACGCACGACTTGAAACACAGATC -> ACGCACGACTTGAAACACAGATCG
ACCAAAAATGTAAATTGGTGCTAC -> CCAAAAATGTAAATTGGTGCTACG
ATATGGGAAACGGCCTAATACTAG -> TATGGGAAACGGCCTAATACTAGT
ATATCTTCTAATCCGCGTGAGGGC -> TATCTTCTAATCCGCGTGAGGGCA
ACAGGGCTGAGTTTTCGTTCGCAA -> CAGGGCTGAGTTTTCGTTCGCAAT
CAATAATCCTTCTAGGCCACCAAC -> AATAATCCTTCTAGGCCACCAACG
CACGGCTACCGCAAGAAAGAGAGA -> ACGGCTACCGCAAGAAAGAGAGAA
AAATTGGTGCTACGCCACGGCGAA -> AATTGGTGCTACGCCACGGCGAAT
ATGTGCATACTAAGCACGTGCAGC -> TGTGCATACTAAGCACGTGCAGCG
AGACTGAATTTAATGGATTAGCGA -> GACTGAATTTAATGGATTAGCGAA
GGTCCACGGCTACCGCAAGAAAGA -> GTCCACGGCTACCGCAAGAAAGAG
GGAGACTGAATTTAATGGATTAGC -> GAGACTGAATTTAATGGATTAGCG
TCTGGCCAATAAATGGACTAGCCT -> CTGGCCAATAAATGGACTAGCCTC
CGGCCTACACGGCAAGATCTTCAG -> GGCCTACACGGCAAGATCTTCAGC
TGAAACACAGATCGACTCAGAAGT -> GAAACACAGATCGACTCAGAAGTA
GCTAACTCAGGGGCGAACCACGCT -> CTAACTCAGGGGCGAACCACGCTG
ATGTCTAGGGTGTTACCATTGGGA -> TGTCTAGGGTGTTACCATTGGGAT
GTTCGCAATGGTAGTTGTCCGATT -> TTCGCAATGGTAGTTGTCCGATTA
CCCGCTTAGACGCCGTAGTAACTT -> CCGCTTAGACGCCGTAGTAACTTT
TACACGGCAAGATCTTCAGCTCCG -> ACACGGCAAGATCTTCAGCTCCGG
GACGCTAAAGAGGGCATACACCAC -> ACGCTAAAGAGGGCATACACCACG
CACGGCCTACACGGCAAGATCTTC -> ACGGCCTACACGGCAAGATCTTCA
CGGGGAAGTTATAATACCAGAGAA -> GGGGAAGTTATAATACCAGAGAAG
CTGCGGTGTCGGCTAGTATCGATA -> TGCGGTGTCGGCTAGTATCGATAA
GCCAATGTATTAGGCGGTCAAGCG -> CCAATGTATTAGGCGGTCAAGCGA
GACGGTACTACAAGGTGCCCCTAA -> ACGGTACTACAAGGTGCCCCTAAC
TTCGCTAGTACCAGAGGGTTTACT -> TCGCTAGTACCAGAGGGTTTACTA
CTACCAAAAATGTAAATTGGTGCT -> TACCAAAAATGTAAATTGGTGCTA
GTTATAATACCAGAGAAGCCGAGG -> TTATAATACCAGAGAAGCCGAGGG
CTAGTATCGATAAAGTATGGCAGA -> TAGTATCGATAAAGTATGGCAGAA
CACTAACCTTTGAGCTAACTCAGG -> ACTAACCTTTGAGCTAACTCAGGG
TAGGTGAATATTTATTTCGGGTGG -> AGGTGAATATTTATTTCGGGTGGC
CTGTAGACGTGGTCTCGCCCCGGC -> TGTAGACGTGGTCTCGCCCCGGCC
GCTGCTATCGAGAAAGGAGCGTAA -> CTGCTATCGAGAAAGGAGCGTAAT
TCCATCTTTTAACGCAGCCGCCGT -> CCATCTTTTAACGCAGCCGCCGTT
CGCTTAGACGCCGTAGTAACTTTC -> GCTTAGACGCCGTAGTAACTTTCA
AGTATAAGGCTTCTATACTTTAAC -> GTATAAGGCTTCTATACTTTAACA
ATGTTGATTGCGGGCCCAGCCTCG -> TGTTGATTGCGGGCCCAGCCTCGG
AGGCGGTCAAGCGATGCGGGGAAG -> GGCGGTCAAGCGATGCGGGGAAGT
TAAATTGGTGCTACGCCACGGCGA -> AAATTGGTGCTACGCCACGGCGAA
TCAACTTAGTATCTGTCTGGCCTG -> CAACTTAGTATCTGTCTGGCCTGG
CGGTCAAGCGATGCGGGGAAGTTA -> GGTCAAGCGATGCGGGGAAGTTAT
TGATGCCGGAAGGTATAATTCGCT -> GATGCCGGAAGGTATAATTCGCTA
AGCCGCCGTTAACTATGCGATAAG -> GCCGCCGTTAACTATGCGATAAGG
ACGCAACCAGGCATGTTTATCTGC -> CGCAACCAGGCATGTTTATCTGCT
GACAAGCGGTTTGGCATTCTGCCA -> ACAAGCGGTTTGGCATTCTGCCAG
GCGGCAGCTGTCTGCTGTAATAAG -> CGGCAGCTGTCTGCTGTAATAAGT
CGCAATGGTAGTTGTCCGATTATC -> GCAATGGTAGTTGTCCGATTATCG
CTAGTGCGCTCGGCCCCGGTATGT -> TAGTGCGCTCGGCCCCGGTATGTA
AAGGTGCCCCTAACACGTTAGGAG -> AGGTGCCCCTAACACGTTAGGAGT
ACGATCGCACATTTTGACGCTAAA -> CGATCGCACATTTTGACGCTAAAG
GCTGAATCTAGTGCGCTCGGCCCC -> CTGAATCTAGTGCGCTCGGCCCCG
TATTTCGGGTGGCGGCCAGGATAG -> ATTTCGGGTGGCGGCCAGGATAGA
GAGAGCATATCTTCTAATCCGCGT -> AGAGCATATCTTCTAATCCGCGTG
AAGATCTTCAGCTCCGGAGGCGTT -> AGATCTTCAGCTCCGGAGGCGTTG
GGCCAGCCTTTTAAGGTAAGCTAC -> GCCAGCCTTTTAAGGTAAGCTACC
CGCCGTAGTAACTTTCAAGAATGT -> GCCGTAGTAACTTTCAAGAATGTT
ATTCTGCCAGTTAAATACTCGGCC -> TTCTGCCAGTTAAATACTCGGCCA
GTGGGCACGAACAATGAGTCAAGA -> TGGGCACGAACAATGAGTCAAGAG
GTGTCACTAACCTTTGAGCTAACT -> TGTCACTAACCTTTGAGCTAACTC
CGTCCTCGGCTGTAGGTCTTGAAC -> GTCCTCGGCTGTAGGTCTTGAACA
CATGATTCTCTATTGACCTATGGT -> ATGATTCTCTATTGACCTATGGTC
GGCATGCTGCTTTCATCTCCAAGT -> GCATGCTGCTTTCATCTCCAAGTG
ACGCAGCCGCCGTTAACTATGCGA -> CGCAGCCGCCGTTAACTATGCGAT
CTCGGCTGTAGGTCTTGAACATCG -> TCGGCTGTAGGTCTTGAACATCGG
TGGGCTAGCACTATGTGTGTGGGC -> GGGCTAGCACTATGTGTGTGGGCA
TCAAACTTTAACGGCATGCTGCTT -> CAAACTTTAACGGCATGCTGCTTT
TAATACTAGTTCCTATGAGAGCAT -> AATACTAGTTCCTATGAGAGCATA
ATAGGTGAATATTTATTTCGGGTG -> TAGGTGAATATTTATTTCGGGTGG
CCAACCAGGTATTACAGGGCTGAG -> CAACCAGGTATTACAGGGCTGAGT
CCACGGCTACCGCAAGAAAGAGAG -> CACGGCTACCGCAAGAAAGAGAGA
TTGCTGCTATCGAGAAAGGAGCGT -> TGCTGCTATCGAGAAAGGAGCGTA
CTTAGGGGGACATGATTCTCTATT -> TTAGGGGGACATGATTCTCTATTG
CTCTGATGAGGCGATTTTGTCAGA -> TCTGATGAGGCGATTTTGTCAGAC
TACTACAAGGTGCCCCTAACACGT -> ACTACAAGGTGCCCCTAACACGTT
CAAACTTTAACGGCATGCTGCTTT -> AAACTTTAACGGCATGCTGCTTTC
GGTAGTTGTCCGATTATCGGTTCC -> GTAGTTGTCCGATTATCGGTTCCG
CCAGACCTGAGTATGATGGGAGTA -> CAGACCTGAGTATGATGGGAGTAA
CAGTATAAGGCTTCTATACTTTAA -> AGTATAAGGCTTCTATACTTTAAC
CTTTTAACGCAGCCGCCGTTAACT -> TTTTAACGCAGCCGCCGTTAACTA
TACGCGGTAGCTGCTGTAGACGTG -> ACGCGGTAGCTGCTGTAGACGTGG
ACACGGCTGTGGTCACGGTCGGAA -> CACGGCTGTGGTCACGGTCGGAAG
TCTATTGACCTATGGTCAAACTTT -> CTATTGACCTATGGTCAAACTTTA
TGGTCCACAATCTAATATCCAACC -> GGTCCACAATCTAATATCCAACCA
GCTGAGTTTTCGTTCGCAATGGTA -> CTGAGTTTTCGTTCGCAATGGTAG
CCAGGCGGCAGCTGTCTGCTGTAA -> CAGGCGGCAGCTGTCTGCTGTAAT
AGGCGTTGGAGACGGTGCCATCGG -> GGCGTTGGAGACGGTGCCATCGGG
TTATACCGTGGGCTAGCACTATGT -> TATACCGTGGGCTAGCACTATGTG
GAAGTAGTTTAATGCCGATCGCGT -> AAGTAGTTTAATGCCGATCGCGTA
CACTCAGATTGCGGGAAGGTATTT -> ACTCAGATTGCGGGAAGGTATTTG
ACAACTTGAGTTGTGCTTAGGGGG -> CAACTTGAGTTGTGCTTAGGGGGA
CAAGGAGCACAGTATATGTCCTAT -> AAGGAGCACAGTATATGTCCTATC
TAGTAACTTTCAAGAATGTTCGCG -> AGTAACTTTCAAGAATGTTCGCGA
ATGGTCAAACTTTAACGGCATGCT -> TGGTCAAACTTTAACGGCATGCTG
TCAGGTGCCCAACCAGGTATTACA -> CAGGTGCCCAACCAGGTATTACAG
CTGTCTGGCCTGGGGGTCCACGGC -> TGTCTGGCCTGGGGGTCCACGGCT
ACGTCCTCGGCTGTAGGTCTTGAA -> CGTCCTCGGCTGTAGGTCTTGAAC
CATACTAAGCACGTGCAGCGTGAT -> ATACTAAGCACGTGCAGCGTGATG
GGTTTACTAGCGGCGTGCCGTACG -> GTTTACTAGCGGCGTGCCGTACGG
GTAATCCGCAATAATCCTTCTAGG -> TAATCCGCAATAATCCTTCTAGGC
GTGGTGGGCCAGCCTTTTAAGGTA -> TGGTGGGCCAGCCTTTTAAGGTAA
GTAGTTGTCCGATTATCGGTTCCG -> TAGTTGTCCGATTATCGGTTCCGT
GGTGGGAAAGCACCGATCTTCGGC -> GTGGGAAAGCACCGATCTTCGGCT
GATTGCGGGAAGGTATTTGCTGCT -> ATTGCGGGAAGGTATTTGCTGCTA
ATGCAGAGATACCACAATCAATTG -> TGCAGAGATACCACAATCAATTGG
CAAGCGATGCGGGGAAGTTATAAT -> AAGCGATGCGGGGAAGTTATAATA
CACGGAGAACGCTGACTCTCCGAC -> ACGGAGAACGCTGACTCTCCGACG
CGCTGACTCTCCGACGTCCTCGGC -> GCTGACTCTCCGACGTCCTCGGCT
TCGCAATGGTAGTTGTCCGATTAT -> CGCAATGGTAGTTGTCCGATTATC
CAGTTAAATACTCGGCCATGATGC -> AGTTAAATACTCGGCCATGATGCC
ATGTAATCCGCAATAATCCTTCTA -> TGTAATCCGCAATAATCCTTCTAG
TATAAGGCTTCTATACTTTAACAC -> ATAAGGCTTCTATACTTTAACACG
TAGAAGCACTGACCAACACGCACG -> AGAAGCACTGACCAACACGCACGA
TATTTGCTGCTATCGAGAAAGGAG -> ATTTGCTGCTATCGAGAAAGGAGC
CTGTAGAGGGTCGGCCAATTATAC -> TGTAGAGGGTCGGCCAATTATACC
TCCACAATCTAATATCCAACCACC -> CCACAATCTAATATCCAACCACCC
TTCCGTTCAGCTTTGAGACTACAA -> TCCGTTCAGCTTTGAGACTACAAG
GATGGGAGTAACCCTTAGCAGTAT -> ATGGGAGTAACCCTTAGCAGTATA
GGCAAGATCTTCAGCTCCGGAGGC -> GCAAGATCTTCAGCTCCGGAGGCG
CCGTACGGATGATGCTGAATCTAG -> CGTACGGATGATGCTGAATCTAGT
CGGAGGCGTTGGAGACGGTGCCAT -> GGAGGCGTTGGAGACGGTGCCATC
CAGGTATTACAGGGCTGAGTTTTC -> AGGTATTACAGGGCTGAGTTTTCG
TGGCAGAACGGGGAGTGATGTGCA -> GGCAGAACGGGGAGTGATGTGCAT
GTGCTACGCCACGGCGAATTTGGT -> TGCTACGCCACGGCGAATTTGGTG
CGTAGTAACTTTCAAGAATGTTCG -> GTAGTAACTTTCAAGAATGTTCGC
TCAATTTCCAAGATAACTCTGCGG -> CAATTTCCAAGATAACTCTGCGGT
GCATATCTTCTAATCCGCGTGAGG -> CATATCTTCTAATCCGCGTGAGGG
ACGTGGTCTCGCCCCGGCCCTAGC -> CGTGGTCTCGCCCCGGCCCTAGCG
AGGATATTAAACTACACGGCTGTG -> GGATATTAAACTACACGGCTGTGG
AGGGCTCACGGTCTAAATCCAGGC -> GGGCTCACGGTCTAAATCCAGGCG
GATCTTGGCCAAGGAGCACAGTAT -> ATCTTGGCCAAGGAGCACAGTATA
TTTCTACCACCTGTCTCTATGCCA -> TTCTACCACCTGTCTCTATGCCAT
CAAGTGGCTTAGCGCCAATGTATT -> AAGTGGCTTAGCGCCAATGTATTA
AACAATGAGTCAAGAGGTTTTGCT -> ACAATGAGTCAAGAGGTTTTGCTT
TTAGAACGTAGCCCCGCTTAGACG -> TAGAACGTAGCCCCGCTTAGACGC
CTGGCCTGGGGGTCCACGGCTACC -> TGGCCTGGGGGTCCACGGCTACCG
GGTGTCGGCTAGTATCGATAAAGT -> GTGTCGGCTAGTATCGATAAAGTA
CCAGCCTTTTAAGGTAAGCTACCA -> CAGCCTTTTAAGGTAAGCTACCAA
CTGGGGGTCCACGGCTACCGCAAG -> TGGGGGTCCACGGCTACCGCAAGA
GTTAAATACTCGGCCATGATGCCG -> TTAAATACTCGGCCATGATGCCGG
TGGTGGGCCAGCCTTTTAAGGTAA -> GGTGGGCCAGCCTTTTAAGGTAAG
GCGAACCACGCTGTCAAATTTACG -> CGAACCACGCTGTCAAATTTACGC
TAAAGTATGGCAGAACGGGGAGTG -> AAAGTATGGCAGAACGGGGAGTGA
AGGAGCACAGTATATGTCCTATCG -> GGAGCACAGTATATGTCCTATCGG
AGCGCCAATGTATTAGGCGGTCAA -> GCGCCAATGTATTAGGCGGTCAAG
TGTGGGCACGAACAATGAGTCAAG -> GTGGGCACGAACAATGAGTCAAGA
GCTTTAACAATATGGTCCACAATC -> CTTTAACAATATGGTCCACAATCT
TGCATCTTCAATTTCCAAGATAAC -> GCATCTTCAATTTCCAAGATAACT
CGTGACTGGTGTAGGAGACTGAAT -> GTGACTGGTGTAGGAGACTGAATT
TGCCCCTAACACGTTAGGAGTGCG -> GCCCCTAACACGTTAGGAGTGCGT
TCGGGTGGCGGCCAGGATAGATTA -> CGGGTGGCGGCCAGGATAGATTAT
CAGAGGGTTTACTAGCGGCGTGCC -> AGAGGGTTTACTAGCGGCGTGCCG
TTAAGGTAAGCTACCAAAAATGTA -> TAAGGTAAGCTACCAAAAATGTAA
CGATAAAGTATGGCAGAACGGGGA -> GATAAAGTATGGCAGAACGGGGAG
TCTAATCCGCGTGAGGGCACAATG -> CTAATCCGCGTGAGGGCACAATGT
ACGTGCAGCGTGATGACAAGCGGT -> CGTGCAGCGTGATGACAAGCGGTT
AAGCCGAGGGCTCACGGTCTAAAT -> AGCCGAGGGCTCACGGTCTAAATC
TGCAGCGTGATGACAAGCGGTTTG -> GCAGCGTGATGACAAGCGGTTTGG
GGTTTGGCATTCTGCCAGTTAAAT -> GTTTGGCATTCTGCCAGTTAAATA
CCTCATCCGTCCAGACCTGAGTAT -> CTCATCCGTCCAGACCTGAGTATG
TATAATACCAGAGAAGCCGAGGGC -> ATAATACCAGAGAAGCCGAGGGCT
AAGAGACATCAACTTAGTATCTGT -> AGAGACATCAACTTAGTATCTGTC
GAATTTAATGGATTAGCGAAATGT -> AATTTAATGGATTAGCGAAATGTT
TTTGACGCTAAAGAGGGCATACAC -> TTGACGCTAAAGAGGGCATACACC
GCAATAATCCTTCTAGGCCACCAA -> CAATAATCCTTCTAGGCCACCAAC
ACGGCCTACACGGCAAGATCTTCA -> CGGCCTACACGGCAAGATCTTCAG
GGCCACCAACGCAACCAGGCATGT -> GCCACCAACGCAACCAGGCATGTT
CATCTCCAAGTGGCTTAGCGCCAA -> ATCTCCAAGTGGCTTAGCGCCAAT
TTGCGGGCCCAGCCTCGGTGGTGG -> TGCGGGCCCAGCCTCGGTGGTGGG
TATACGCGGTAGCTGCTGTAGACG -> ATACGCGGTAGCTGCTGTAGACGT
TGCTACGCCACGGCGAATTTGGTG -> GCTACGCCACGGCGAATTTGGTGA
AAGCACCGATCTTCGGCTTCATGC -> AGCACCGATCTTCGGCTTCATGCA
TAAGCTACCAAAAATGTAAATTGG -> AAGCTACCAAAAATGTAAATTGGT
CTGCTGTAGACGTGGTCTCGCCCC -> TGCTGTAGACGTGGTCTCGCCCCG
CCTGGGGGTCCACGGCTACCGCAA -> CTGGGGGTCCACGGCTACCGCAAG
CGACGGTACTACAAGGTGCCCCTA -> GACGGTACTACAAGGTGCCCCTAA
TTAGTCACTTCGCATTTATTCTCT -> TAGTCACTTCGCATTTATTCTCTC
GATTATAGAAGCACTGACCAACAC -> ATTATAGAAGCACTGACCAACACG
CCAACACGCACGACTTGAAACACA -> CAACACGCACGACTTGAAACACAG
CCAATTATACCGTGGGCTAGCACT -> CAATTATACCGTGGGCTAGCACTA
TTAACAATATGGTCCACAATCTAA -> TAACAATATGGTCCACAATCTAAT
GATAAAGTATGGCAGAACGGGGAG -> ATAAAGTATGGCAGAACGGGGAGT
AGGTGAATATTTATTTCGGGTGGC -> GGTGAATATTTATTTCGGGTGGCG
ATACCAGAGAAGCCGAGGGCTCAC -> TACCAGAGAAGCCGAGGGCTCACG
GTAATAAGTGGACCTCATCCGTCC -> TAATAAGTGGACCTCATCCGTCCA
CCTTAGCAGTATAAGGCTTCTATA -> CTTAGCAGTATAAGGCTTCTATAC
TATACCGTGGGCTAGCACTATGTG -> ATACCGTGGGCTAGCACTATGTGT
AATGCCGATCGCGTAGGATATTAA -> ATGCCGATCGCGTAGGATATTAAA
AGCCCCGCTTAGACGCCGTAGTAA -> GCCCCGCTTAGACGCCGTAGTAAC
ACACAGATCGACTCAGAAGTAGTT -> CACAGATCGACTCAGAAGTAGTTT
GCGTAATCCATGGGTGCATCTTCA -> CGTAATCCATGGGTGCATCTTCAA
GGGCTCACGGTCTAAATCCAGGCG -> GGCTCACGGTCTAAATCCAGGCGG
CTAGTACCAGAGGGTTTACTAGCG -> TAGTACCAGAGGGTTTACTAGCGG
AACACGGCCTACACGGCAAGATCT -> ACACGGCCTACACGGCAAGATCTT
GTGCATACTAAGCACGTGCAGCGT -> TGCATACTAAGCACGTGCAGCGTG
GGGGGACATGATTCTCTATTGACC -> GGGGACATGATTCTCTATTGACCT
GATTAGCGAAATGTTGATTGCGGG -> ATTAGCGAAATGTTGATTGCGGGC
GTTTACTAGCGGCGTGCCGTACGG -> TTTACTAGCGGCGTGCCGTACGGA
GGCGATTAGTCACTTCGCATTTAT -> GCGATTAGTCACTTCGCATTTATT
ATCCGCAATAATCCTTCTAGGCCA -> TCCGCAATAATCCTTCTAGGCCAC
TGAGTCAAGAGGTTTTGCTTATAC -> GAGTCAAGAGGTTTTGCTTATACG
TGATGAGGCGATTTTGTCAGACAG -> GATGAGGCGATTTTGTCAGACAGA
TGCGGGCCCAGCCTCGGTGGTGGG -> GCGGGCCCAGCCTCGGTGGTGGGC
CCAGGATAGATTATAGAAGCACTG -> CAGGATAGATTATAGAAGCACTGA
TACCATTGGGATCTTGGCCAAGGA -> ACCATTGGGATCTTGGCCAAGGAG
TCTTTTAACGCAGCCGCCGTTAAC -> CTTTTAACGCAGCCGCCGTTAACT
AACTTGAGTTGTGCTTAGGGGGAC -> ACTTGAGTTGTGCTTAGGGGGACA
TCAAGAATGTTCGCGACCGTTATT -> CAAGAATGTTCGCGACCGTTATTG
AAGCACGTGCAGCGTGATGACAAG -> AGCACGTGCAGCGTGATGACAAGC
AACGCAGCCGCCGTTAACTATGCG -> ACGCAGCCGCCGTTAACTATGCGA
GTAAGCTACCAAAAATGTAAATTG -> TAAGCTACCAAAAATGTAAATTGG
GGAGTAACCCTTAGCAGTATAAGG -> GAGTAACCCTTAGCAGTATAAGGC
ATGCCATATGGGAAACGGCCTAAT -> TGCCATATGGGAAACGGCCTAATA
GCTGCTTTCATCTCCAAGTGGCTT -> CTGCTTTCATCTCCAAGTGGCTTA
CATTTTGACGCTAAAGAGGGCATA -> ATTTTGACGCTAAAGAGGGCATAC
GCTTTGAGACTACAAGCGGTATGC -> CTTTGAGACTACAAGCGGTATGCG
TGAGACTACAAGCGGTATGCGATG -> GAGACTACAAGCGGTATGCGATGA
AGTATATGTCCTATCGGACCACTA -> GTATATGTCCTATCGGACCACTAG
AGACCGGAAACATGTCTAGGGTGT -> GACCGGAAACATGTCTAGGGTGTT
GACGTCCTCGGCTGTAGGTCTTGA -> ACGTCCTCGGCTGTAGGTCTTGAA
TGATTCTCTATTGACCTATGGTCA -> GATTCTCTATTGACCTATGGTCAA
GGCCAAGGAGCACAGTATATGTCC -> GCCAAGGAGCACAGTATATGTCCT
CGTTATTGATACGTGGGACCGGGA -> GTTATTGATACGTGGGACCGGGAG
TTAGACGCCGTAGTAACTTTCAAG -> TAGACGCCGTAGTAACTTTCAAGA
CACGACTTGAAACACAGATCGACT -> ACGACTTGAAACACAGATCGACTC
TACAGGGCTGAGTTTTCGTTCGCA -> ACAGGGCTGAGTTTTCGTTCGCAA
GGATGCAGAGATACCACAATCAAT -> GATGCAGAGATACCACAATCAATT
TCGTTGTCTCCTCAAACAACTTGA -> CGTTGTCTCCTCAAACAACTTGAG
ACTAGTTCCTATGAGAGCATATCT -> CTAGTTCCTATGAGAGCATATCTT
ACTGAATTTAATGGATTAGCGAAA -> CTGAATTTAATGGATTAGCGAAAT
GACCTCATCCGTCCAGACCTGAGT -> ACCTCATCCGTCCAGACCTGAGTA
TCTGATGAGGCGATTTTGTCAGAC -> CTGATGAGGCGATTTTGTCAGACA
GGCCAATTATACCGTGGGCTAGCA -> GCCAATTATACCGTGGGCTAGCAC
AATCCATGGGTGCATCTTCAATTT -> ATCCATGGGTGCATCTTCAATTTC
GGATATTAAACTACACGGCTGTGG -> GATATTAAACTACACGGCTGTGGT
CAAGCGGTTTGGCATTCTGCCAGT -> AAGCGGTTTGGCATTCTGCCAGTT
TTATAATACCAGAGAAGCCGAGGG -> TATAATACCAGAGAAGCCGAGGGC
ATACCGGTGGGAAAGCACCGATCT -> TACCGGTGGGAAAGCACCGATCTT
CGGCTTCATGCACACTAACGTTGT -> GGCTTCATGCACACTAACGTTGTT
CATGTCTAGGGTGTTACCATTGGG -> ATGTCTAGGGTGTTACCATTGGGA
TGGTGCTACGCCACGGCGAATTTG -> GGTGCTACGCCACGGCGAATTTGG
GCCGCCGTTAACTATGCGATAAGG -> CCGCCGTTAACTATGCGATAAGGT
GTCAAACTTTAACGGCATGCTGCT -> TCAAACTTTAACGGCATGCTGCTT
CTGAGTTTTCGTTCGCAATGGTAG -> TGAGTTTTCGTTCGCAATGGTAGT
TCTCTGATGAGGCGATTTTGTCAG -> CTCTGATGAGGCGATTTTGTCAGA
TGGTCAAACTTTAACGGCATGCTG -> GGTCAAACTTTAACGGCATGCTGC
GCGGTCAAGCGATGCGGGGAAGTT -> CGGTCAAGCGATGCGGGGAAGTTA
AATTATACCGTGGGCTAGCACTAT -> ATTATACCGTGGGCTAGCACTATG
ATGCGATGACGAGTACTGAATCGT -> TGCGATGACGAGTACTGAATCGTT
TAAGGCTTCTATACTTTAACACGG -> AAGGCTTCTATACTTTAACACGGC
CTTTAACAATATGGTCCACAATCT -> TTTAACAATATGGTCCACAATCTA
CGTGCAGCGTGATGACAAGCGGTT -> GTGCAGCGTGATGACAAGCGGTTT
TCTGTAGAGGGTCGGCCAATTATA -> CTGTAGAGGGTCGGCCAATTATAC
AGGAGTGCGTCTGGCCAATAAATG -> GGAGTGCGTCTGGCCAATAAATGG
AAACTACACGGCTGTGGTCACGGT -> AACTACACGGCTGTGGTCACGGTC
TCACGGTCTAAATCCAGGCGGCAG -> CACGGTCTAAATCCAGGCGGCAGC
TAGCCCCGCTTAGACGCCGTAGTA -> AGCCCCGCTTAGACGCCGTAGTAA
TGTAGAGGGTCGGCCAATTATACC -> GTAGAGGGTCGGCCAATTATACCG
GACCAACACGCACGACTTGAAACA -> ACCAACACGCACGACTTGAAACAC
TTACTAGCGGCGTGCCGTACGGAT -> TACTAGCGGCGTGCCGTACGGATG
CAGCTCCGGAGGCGTTGGAGACGG -> AGCTCCGGAGGCGTTGGAGACGGT
GACCTATGGTCAAACTTTAACGGC -> ACCTATGGTCAAACTTTAACGGCA
AACGCTGACTCTCCGACGTCCTCG -> ACGCTGACTCTCCGACGTCCTCGG
ATGGCAGAACGGGGAGTGATGTGC -> TGGCAGAACGGGGAGTGATGTGCA
TAACTTTCAAGAATGTTCGCGACC -> AACTTTCAAGAATGTTCGCGACCG
ACATCGGAAGAGACATCAACTTAG -> CATCGGAAGAGACATCAACTTAGT
GCGGTATGCGATGACGAGTACTGA -> CGGTATGCGATGACGAGTACTGAA
GACTCAGAAGTAGTTTAATGCCGA -> ACTCAGAAGTAGTTTAATGCCGAT
CATCTTCAATTTCCAAGATAACTC -> ATCTTCAATTTCCAAGATAACTCT
ATATGGTCCACAATCTAATATCCA -> TATGGTCCACAATCTAATATCCAA
TGGCATTCTGCCAGTTAAATACTC -> GGCATTCTGCCAGTTAAATACTCG
AATGGATTAGCGAAATGTTGATTG -> ATGGATTAGCGAAATGTTGATTGC
GGTCAAACTTTAACGGCATGCTGC -> GTCAAACTTTAACGGCATGCTGCT
TATAATTCGCTAGTACCAGAGGGT -> ATAATTCGCTAGTACCAGAGGGTT
GGGCATACACCACGGAGAACGCTG -> GGCATACACCACGGAGAACGCTGA
CTGTCTGCTGTAATAAGTGGACCT -> TGTCTGCTGTAATAAGTGGACCTC
TACAAGCGGTATGCGATGACGAGT -> ACAAGCGGTATGCGATGACGAGTA
ACTCGGCCATGATGCCGGAAGGTA -> CTCGGCCATGATGCCGGAAGGTAT
CGGTCGGAAGAGACATATTCAGGT -> GGTCGGAAGAGACATATTCAGGTG
CAACCACCCGGCGATTAGTCACTT -> AACCACCCGGCGATTAGTCACTTC
AGCGGCGTGCCGTACGGATGATGC -> GCGGCGTGCCGTACGGATGATGCT
TGATACGTGGGACCGGGAGAGACC -> GATACGTGGGACCGGGAGAGACCG
GCCAGGATAGATTATAGAAGCACT -> CCAGGATAGATTATAGAAGCACTG
TTTAACAATATGGTCCACAATCTA -> TTAACAATATGGTCCACAATCTAA
CTTGGCCAAGGAGCACAGTATATG -> TTGGCCAAGGAGCACAGTATATGT
GACAGACAATACCGGTGGGAAAGC -> ACAGACAATACCGGTGGGAAAGCA
CTTGAACATCGGAAGAGACATCAA -> TTGAACATCGGAAGAGACATCAAC
GCTCGGCCCCGGTATGTAATCCGC -> CTCGGCCCCGGTATGTAATCCGCA
AGCTCCGGAGGCGTTGGAGACGGT -> GCTCCGGAGGCGTTGGAGACGGTG
TTGTCAGACAGACAATACCGGTGG -> TGTCAGACAGACAATACCGGTGGG
ATAGATTATAGAAGCACTGACCAA -> TAGATTATAGAAGCACTGACCAAC
GAAACACAGATCGACTCAGAAGTA -> AAACACAGATCGACTCAGAAGTAG
GGGGAAGTTATAATACCAGAGAAG -> GGGAAGTTATAATACCAGAGAAGC
ACCCGGCGATTAGTCACTTCGCAT -> CCCGGCGATTAGTCACTTCGCATT
ATCTTTTAACGCAGCCGCCGTTAA -> TCTTTTAACGCAGCCGCCGTTAAC
ACAAGCGGTTTGGCATTCTGCCAG -> CAAGCGGTTTGGCATTCTGCCAGT
CTAAGGATGCAGAGATACCACAAT -> TAAGGATGCAGAGATACCACAATC
GATATTAAACTACACGGCTGTGGT -> ATATTAAACTACACGGCTGTGGTC
ACCACAATCAATTGGTTTTCTACC -> CCACAATCAATTGGTTTTCTACCA
GGTCACGGTCGGAAGAGACATATT -> GTCACGGTCGGAAGAGACATATTC
CGGTGGTGGGCCAGCCTTTTAAGG -> GGTGGTGGGCCAGCCTTTTAAGGT
CGCCAAGATTCCATCTTTTAACGC -> GCCAAGATTCCATCTTTTAACGCA
CCGCAAGAAAGAGAGAACACGTGA -> CGCAAGAAAGAGAGAACACGTGAC
TGGGACCGGGAGAGACCGGAAACA -> GGGACCGGGAGAGACCGGAAACAT
CTCGGCCCCGGTATGTAATCCGCA -> TCGGCCCCGGTATGTAATCCGCAA
AGCTGCTGTAGACGTGGTCTCGCC -> GCTGCTGTAGACGTGGTCTCGCCC
TTGATTGCGGGCCCAGCCTCGGTG -> TGATTGCGGGCCCAGCCTCGGTGG
TATTCTCTCGACGGTACTACAAGG -> ATTCTCTCGACGGTACTACAAGGT
TCTCTCGACGGTACTACAAGGTGC -> CTCTCGACGGTACTACAAGGTGCC
GTTATTGATACGTGGGACCGGGAG -> TTATTGATACGTGGGACCGGGAGA
GCTTAGGGGGACATGATTCTCTAT -> CTTAGGGGGACATGATTCTCTATT
CCAACGCAACCAGGCATGTTTATC -> CAACGCAACCAGGCATGTTTATCT
GTAAATTGGTGCTACGCCACGGCG -> TAAATTGGTGCTACGCCACGGCGA
AATACTAGTTCCTATGAGAGCATA -> ATACTAGTTCCTATGAGAGCATAT
GGAAGTTATAATACCAGAGAAGCC -> GAAGTTATAATACCAGAGAAGCCG
AAGTATGGCAGAACGGGGAGTGAT -> AGTATGGCAGAACGGGGAGTGATG
CTACAAGGTGCCCCTAACACGTTA -> TACAAGGTGCCCCTAACACGTTAG
CCGGTATGTAATCCGCAATAATCC -> CGGTATGTAATCCGCAATAATCCT
CGGCCAATTATACCGTGGGCTAGC -> GGCCAATTATACCGTGGGCTAGCA
CGTTCGCAATGGTAGTTGTCCGAT -> GTTCGCAATGGTAGTTGTCCGATT
GACCGGGAGAGACCGGAAACATGT -> ACCGGGAGAGACCGGAAACATGTC
ATACGATCGCACATTTTGACGCTA -> TACGATCGCACATTTTGACGCTAA
AGAGAACACGTGACTGGTGTAGGA -> GAGAACACGTGACTGGTGTAGGAG
GATCGCACATTTTGACGCTAAAGA -> ATCGCACATTTTGACGCTAAAGAG
GCGATGACGAGTACTGAATCGTTG -> CGATGACGAGTACTGAATCGTTGT
ATGTTTATCTGCTACTGCCGCCAA -> TGTTTATCTGCTACTGCCGCCAAG
TGATGGGAGTAACCCTTAGCAGTA -> GATGGGAGTAACCCTTAGCAGTAT
CGGAGAACGCTGACTCTCCGACGT -> GGAGAACGCTGACTCTCCGACGTC
ATAAGGTCCATACGATCGCACATT -> TAAGGTCCATACGATCGCACATTT
AACGGCATGCTGCTTTCATCTCCA -> ACGGCATGCTGCTTTCATCTCCAA
CTTAGCAGTATAAGGCTTCTATAC -> TTAGCAGTATAAGGCTTCTATACT
ACTATGTGTGTGGGCACGAACAAT -> CTATGTGTGTGGGCACGAACAATG
AGCACCGATCTTCGGCTTCATGCA -> GCACCGATCTTCGGCTTCATGCAC
ACCAACGCAACCAGGCATGTTTAT -> CCAACGCAACCAGGCATGTTTATC
TGCCGGAAGGTATAATTCGCTAGT -> GCCGGAAGGTATAATTCGCTAGTA
GCTACTGCCGCCAAGATTCCATCT -> CTACTGCCGCCAAGATTCCATCTT
CTATTGACCTATGGTCAAACTTTA -> TATTGACCTATGGTCAAACTTTAA
TAAATGGACTAGCCTCTCTGATGA -> AAATGGACTAGCCTCTCTGATGAG
GAGACTACAAGCGGTATGCGATGA -> AGACTACAAGCGGTATGCGATGAC
ACGTGGGACCGGGAGAGACCGGAA -> CGTGGGACCGGGAGAGACCGGAAA
TTAAACTACACGGCTGTGGTCACG -> TAAACTACACGGCTGTGGTCACGG
AGTGCGTCTGGCCAATAAATGGAC -> GTGCGTCTGGCCAATAAATGGACT
GTCCGCTAGCTTTAACAATATGGT -> TCCGCTAGCTTTAACAATATGGTC
GCACACTAACGTTGTTCTGTAGAG -> CACACTAACGTTGTTCTGTAGAGG
TGTCTCCTCAAACAACTTGAGTTG -> GTCTCCTCAAACAACTTGAGTTGT
GCCTCTCTGATGAGGCGATTTTGT -> CCTCTCTGATGAGGCGATTTTGTC
AATTTGGTGATCTCAGTTTAGAAC -> ATTTGGTGATCTCAGTTTAGAACG
GAGGGTTTACTAGCGGCGTGCCGT -> AGGGTTTACTAGCGGCGTGCCGTA
AGCAGTATAAGGCTTCTATACTTT -> GCAGTATAAGGCTTCTATACTTTA
AGTAACTTTCAAGAATGTTCGCGA -> GTAACTTTCAAGAATGTTCGCGAC
GCGTCTGGCCAATAAATGGACTAG -> CGTCTGGCCAATAAATGGACTAGC
ATGGGAGTAACCCTTAGCAGTATA -> TGGGAGTAACCCTTAGCAGTATAA
TTAACACGGCCTACACGGCAAGAT -> TAACACGGCCTACACGGCAAGATC
GTAGTTTAATGCCGATCGCGTAGG -> TAGTTTAATGCCGATCGCGTAGGA
TCCGCAATAATCCTTCTAGGCCAC -> CCGCAATAATCCTTCTAGGCCACC
CTCACGGTCTAAATCCAGGCGGCA -> TCACGGTCTAAATCCAGGCGGCAG
GATGCTGAATCTAGTGCGCTCGGC -> ATGCTGAATCTAGTGCGCTCGGCC
TGCAGAGATACCACAATCAATTGG -> GCAGAGATACCACAATCAATTGGT
GCGAATTTGGTGATCTCAGTTTAG -> CGAATTTGGTGATCTCAGTTTAGA
TGTTACCATTGGGATCTTGGCCAA -> GTTACCATTGGGATCTTGGCCAAG
ACAGTATATGTCCTATCGGACCAC -> CAGTATATGTCCTATCGGACCACT
ACTAAGCACGTGCAGCGTGATGAC -> CTAAGCACGTGCAGCGTGATGACA
GAGTACTGAATCGTTGTCTCCTCA -> AGTACTGAATCGTTGTCTCCTCAA
CACGGCAAGATCTTCAGCTCCGGA -> ACGGCAAGATCTTCAGCTCCGGAG
CATACACCACGGAGAACGCTGACT -> ATACACCACGGAGAACGCTGACTC
GGCACAATGTCCGCTAGCTTTAAC -> GCACAATGTCCGCTAGCTTTAACA
ATGTTCGCGACCGTTATTGATACG -> TGTTCGCGACCGTTATTGATACGT
TAACACGGCCTACACGGCAAGATC -> AACACGGCCTACACGGCAAGATCT
GGACCTCATCCGTCCAGACCTGAG -> GACCTCATCCGTCCAGACCTGAGT
AGCACGTGCAGCGTGATGACAAGC -> GCACGTGCAGCGTGATGACAAGCG
CGCTAGCTTTAACAATATGGTCCA -> GCTAGCTTTAACAATATGGTCCAC
CCTCTCTGATGAGGCGATTTTGTC -> CTCTCTGATGAGGCGATTTTGTCA
GGTCCACAATCTAATATCCAACCA -> GTCCACAATCTAATATCCAACCAC
GGGAAACGGCCTAATACTAGTTCC -> GGAAACGGCCTAATACTAGTTCCT
AGCATATCTTCTAATCCGCGTGAG -> GCATATCTTCTAATCCGCGTGAGG
GATACCACAATCAATTGGTTTTCT -> ATACCACAATCAATTGGTTTTCTA
TAGAACGTAGCCCCGCTTAGACGC -> AGAACGTAGCCCCGCTTAGACGCC
ATGCTGCTTTCATCTCCAAGTGGC -> TGCTGCTTTCATCTCCAAGTGGCT
GCGGTAGCTGCTGTAGACGTGGTC -> CGGTAGCTGCTGTAGACGTGGTCT
AACGCAACCAGGCATGTTTATCTG -> ACGCAACCAGGCATGTTTATCTGC
GATTCTCTATTGACCTATGGTCAA -> ATTCTCTATTGACCTATGGTCAAA
GGTAGCTGCTGTAGACGTGGTCTC -> GTAGCTGCTGTAGACGTGGTCTCG
GACTGGTGTAGGAGACTGAATTTA -> ACTGGTGTAGGAGACTGAATTTAA
CCCGGTATGTAATCCGCAATAATC -> CCGGTATGTAATCCGCAATAATCC
CGGCGAATTTGGTGATCTCAGTTT -> GGCGAATTTGGTGATCTCAGTTTA
GGAGGCGTTGGAGACGGTGCCATC -> GAGGCGTTGGAGACGGTGCCATCG
GAGACATATTCAGGTGCCCAACCA -> AGACATATTCAGGTGCCCAACCAG
GCGACCGTTATTGATACGTGGGAC -> CGACCGTTATTGATACGTGGGACC
TTTAACGCAGCCGCCGTTAACTAT -> TTAACGCAGCCGCCGTTAACTATG
GCTCACGGTCTAAATCCAGGCGGC -> CTCACGGTCTAAATCCAGGCGGCA
GAATCGTTGTCTCCTCAAACAACT -> AATCGTTGTCTCCTCAAACAACTT
TTCAAGAATGTTCGCGACCGTTAT -> TCAAGAATGTTCGCGACCGTTATT
CATGATGCCGGAAGGTATAATTCG -> ATGATGCCGGAAGGTATAATTCGC
GCGTGCCGTACGGATGATGCTGAA -> CGTGCCGTACGGATGATGCTGAAT
AGCGATGCGGGGAAGTTATAATAC -> GCGATGCGGGGAAGTTATAATACC
GGGGGTCCACGGCTACCGCAAGAA -> GGGGTCCACGGCTACCGCAAGAAA
ATACCACAATCAATTGGTTTTCTA -> TACCACAATCAATTGGTTTTCTAC
GTTTAATGCCGATCGCGTAGGATA -> TTTAATGCCGATCGCGTAGGATAT
TGCGGTGTCGGCTAGTATCGATAA -> GCGGTGTCGGCTAGTATCGATAAA
TAGGAGACTGAATTTAATGGATTA -> AGGAGACTGAATTTAATGGATTAG
TTGATACGTGGGACCGGGAGAGAC -> TGATACGTGGGACCGGGAGAGACC
GCTAAAGAGGGCATACACCACGGA -> CTAAAGAGGGCATACACCACGGAG
CCGGCCCTAGCGGAAGTCGATAGG -> CGGCCCTAGCGGAAGTCGATAGGT
AAGGAGCACAGTATATGTCCTATC -> AGGAGCACAGTATATGTCCTATCG
GGGACCGGGAGAGACCGGAAACAT -> GGACCGGGAGAGACCGGAAACATG
CCAATGTATTAGGCGGTCAAGCGA -> CAATGTATTAGGCGGTCAAGCGAT
TCTTGAACATCGGAAGAGACATCA -> CTTGAACATCGGAAGAGACATCAA
TGAGTTGTGCTTAGGGGGACATGA -> GAGTTGTGCTTAGGGGGACATGAT
AGGTTTTGCTTATACGCGGTAGCT -> GGTTTTGCTTATACGCGGTAGCTG
GTAGGATATTAAACTACACGGCTG -> TAGGATATTAAACTACACGGCTGT
GATAGGTGAATATTTATTTCGGGT -> ATAGGTGAATATTTATTTCGGGTG
GTCTGGCCAATAAATGGACTAGCC -> TCTGGCCAATAAATGGACTAGCCT
